id,release_date,movie_title,production_budget,domestic_gross,worldwide_gross,release_year,foreign_gross,movie_id,movie_id2
1,2009-12-18,avatar,425000000,760507625,2776345279,2009,2015837654,avatar20091218,avatar2009
2,2011-05-20,pirates of the caribbean: on stranger tides,410600000,241063875,1045663875,2011,804600000,piratesofthecaribbeanonstrangertides20110520,pirates of the caribbean: on stranger tides2011
3,2019-06-07,dark phoenix,350000000,42762350,149762350,2019,107000000,darkphoenix20190607,dark phoenix2019
4,2015-05-01,avengers: age of ultron,330600000,459005868,1403013963,2015,944008095,avengersageofultron20150501,avengers: age of ultron2015
5,2017-12-15,star wars ep. viii: the last jedi,317000000,620181382,1316721747,2017,696540365,starwarsepviiithelastjedi20171215,star wars ep. viii: the last jedi2017
6,2015-12-18,star wars ep. vii: the force awakens,306000000,936662225,2053311220,2015,1116648995,starwarsepviitheforceawakens20151218,star wars ep. vii: the force awakens2015
7,2018-04-27,avengers: infinity war,300000000,678815482,2048134200,2018,1369318718,avengersinfinitywar20180427,avengers: infinity war2018
8,2007-05-24,pirates of the caribbean: at worldâs end,300000000,309420425,963420425,2007,654000000,piratesofthecaribbeanatworldâsend20070524,pirates of the caribbean: at worldâs end2007
9,2017-11-17,justice league,300000000,229024295,655945209,2017,426920914,justiceleague20171117,justice league2017
10,2015-11-06,spectre,300000000,200074175,879620923,2015,679546748,spectre20151106,spectre2015
11,2012-07-20,the dark knight rises,275000000,448139099,1084439099,2012,636300000,thedarkknightrises20120720,the dark knight rises2012
12,2018-05-25,solo: a star wars story,275000000,213767512,393151347,2018,179383835,soloastarwarsstory20180525,solo: a star wars story2018
13,2013-07-02,the lone ranger,275000000,89302115,260002115,2013,170700000,theloneranger20130702,the lone ranger2013
14,2012-03-09,john carter,275000000,73058679,282778100,2012,209719421,johncarter20120309,john carter2012
15,2010-11-24,tangled,260000000,200821936,586477240,2010,385655304,tangled20101124,tangled2010
16,2007-05-04,spider-man 3,258000000,336530303,894860230,2007,558329927,spiderman320070504,spider-man 32007
17,2016-05-06,captain america: civil war,250000000,408084349,1140069413,2016,731985064,captainamericacivilwar20160506,captain america: civil war2016
18,2016-03-25,batman v superman: dawn of justice,250000000,330360194,867500281,2016,537140087,batmanvsupermandawnofjustice20160325,batman v superman: dawn of justice2016
19,2012-12-14,the hobbit: an unexpected journey,250000000,303003568,1017003568,2012,714000000,thehobbitanunexpectedjourney20121214,the hobbit: an unexpected journey2012
20,2009-07-15,harry potter and the half-blood prince,250000000,302089278,935213767,2009,633124489,harrypotterandthehalfbloodprince20090715,harry potter and the half-blood prince2009
21,2013-12-13,the hobbit: the desolation of smaug,250000000,258366855,960366855,2013,702000000,thehobbitthedesolationofsmaug20131213,the hobbit: the desolation of smaug2013
22,2014-12-17,the hobbit: the battle of the five armies,250000000,255119788,945577621,2014,690457833,thehobbitthebattleofthefivearmies20141217,the hobbit: the battle of the five armies2014
23,2017-04-14,the fate of the furious,250000000,225764765,1234846267,2017,1009081502,thefateofthefurious20170414,the fate of the furious2017
24,2006-06-28,superman returns,232000000,200120000,374085065,2006,173965065,supermanreturns20060628,superman returns2006
25,2017-05-26,pirates of the caribbean: dead men tell no tales,230000000,172558876,788241137,2017,615682261,piratesofthecaribbeandeadmentellnotales20170526,pirates of the caribbean: dead men tell no tales2017
26,2008-11-14,quantum of solace,230000000,169368427,591692078,2008,422323651,quantumofsolace20081114,quantum of solace2008
27,2012-05-04,the avengers,225000000,623279547,1517935897,2012,894656350,theavengers20120504,the avengers2012
28,2006-07-07,pirates of the caribbean: dead manâs chest,225000000,423315812,1066215812,2006,642900000,piratesofthecaribbeandeadmanâschest20060707,pirates of the caribbean: dead manâs chest2006
29,2013-06-14,man of steel,225000000,291045518,667999518,2013,376954000,manofsteel20130614,man of steel2013
30,2008-05-16,the chronicles of narnia: prince caspian,225000000,141621490,417341288,2008,275719798,thechroniclesofnarniaprincecaspian20080516,the chronicles of narnia: prince caspian2008
31,2012-07-03,the amazing spider-man,220000000,262030663,757890267,2012,495859604,theamazingspiderman20120703,the amazing spider-man2012
32,2012-05-18,battleship,220000000,65233400,313477717,2012,248244317,battleship20120518,battleship2012
33,2017-06-21,transformers: the last knight,217000000,130168683,602893340,2017,472724657,transformersthelastknight20170621,transformers: the last knight2017
34,2015-06-12,jurassic world,215000000,652270625,1648854864,2015,996584239,jurassicworld20150612,jurassic world2015
35,2012-05-25,men in black 3,215000000,179020854,654213485,2012,475192631,meninblack320120525,men in black 32012
36,2009-06-24,transformers: revenge of the fallen,210000000,402111870,836519699,2009,434407829,transformersrevengeofthefallen20090624,transformers: revenge of the fallen2009
37,2014-06-27,transformers: age of extinction,210000000,245439076,1104039076,2014,858600000,transformersageofextinction20140627,transformers: age of extinction2014
38,2006-05-26,x-men: the last stand,210000000,234362462,459260946,2006,224898484,xmenthelaststand20060526,x-men: the last stand2006
39,2010-05-14,robin hood,210000000,105487148,322459006,2010,216971858,robinhood20100514,robin hood2010
40,2005-12-14,king kong,207000000,218080025,550517357,2005,332437332,kingkong20051214,king kong2005
41,2007-12-07,the golden compass,205000000,70107728,367262558,2007,297154830,thegoldencompass20071207,the golden compass2007
42,2018-02-16,black panther,200000000,700059566,1348258224,2018,648198658,blackpanther20180216,black panther2018
44,2018-06-15,incredibles 2,200000000,608581744,1242520711,2018,633938967,incredibles220180615,incredibles 22018
45,2016-12-16,rogue one: a star wars story,200000000,532177324,1049102856,2016,516925532,rogueoneastarwarsstory20161216,rogue one: a star wars story2016
46,2016-06-17,finding dory,200000000,486295561,1021215193,2016,534919632,findingdory20160617,finding dory2016
47,2010-06-18,toy story 3,200000000,415004880,1068879522,2010,653874642,toystory320100618,toy story 32010
48,2013-05-03,iron man 3,200000000,408992272,1215392272,2013,806400000,ironman320130503,iron man 32013
49,2017-05-05,guardians of the galaxy vol 2,200000000,389813101,862316233,2017,472503132,guardiansofthegalaxyvol220170505,guardians of the galaxy vol 22017
50,2004-06-30,spider-man 2,200000000,373524485,795110670,2004,421586185,spiderman220040630,spider-man 22004
51,2010-03-05,alice in wonderland,200000000,334191110,1025491110,2010,691300000,aliceinwonderland20100305,alice in wonderland2010
52,2012-11-08,skyfall,200000000,304360277,1110526981,2012,806166704,skyfall20121108,skyfall2012
53,2013-06-21,monsters university,200000000,268488329,743588329,2013,475100000,monstersuniversity20130621,monsters university2013
54,2013-03-08,oz the great and powerful,200000000,234770996,490359051,2013,255588055,ozthegreatandpowerful20130308,oz the great and powerful2013
55,2014-05-23,x-men: days of future past,200000000,233921534,747862775,2014,513941241,xmendaysoffuturepast20140523,x-men: days of future past2014
56,2014-05-02,the amazing spider-man 2,200000000,202853933,708996336,2014,506142403,theamazingspiderman220140502,the amazing spider-man 22014
57,2011-06-24,cars 2,200000000,191450875,560155383,2011,368704508,cars220110624,cars 22011
58,2010-12-17,tron: legacy,200000000,172062763,400062763,2010,228000000,tronlegacy20101217,tron: legacy2010
59,2009-11-13,2012,200000000,166112167,757677748,2009,591565581,201220091113,20122009
60,2018-11-16,fantastic beasts: the crimes of grindelwald,200000000,159555901,652220086,2018,492664185,fantasticbeaststhecrimesofgrindelwald20181116,fantastic beasts: the crimes of grindelwald2018
61,2009-05-21,terminator salvation,200000000,125322469,365491792,2009,240169323,terminatorsalvation20090521,terminator salvation2009
62,2011-06-17,green lantern,200000000,116601172,219535492,2011,102934320,greenlantern20110617,green lantern2011
63,2010-05-28,prince of persia: sands of time,200000000,90759676,336359676,2010,245600000,princeofpersiasandsoftime20100528,prince of persia: sands of time2010
64,2011-06-29,transformers: dark of the moon,195000000,352390543,1123790543,2011,771400000,transformersdarkofthemoon20110629,transformers: dark of the moon2011
65,2017-06-09,the mummy,195000000,80101125,409953905,2017,329852780,themummy20170609,the mummy2017
66,2013-03-01,jack the giant slayer,195000000,65187603,197687603,2013,132500000,jackthegiantslayer20130301,jack the giant slayer2013
67,2015-04-03,furious 7,190000000,353007020,1518722794,2015,1165715774,furious720150403,furious 72015
68,2013-05-16,star trek into darkness,190000000,228778661,467381584,2013,238602923,startrekintodarkness20130516,star trek into darkness2013
69,2013-06-21,world war z,190000000,202359711,531514650,2013,329154939,worldwarz20130621,world war z2013
70,2013-05-10,the great gatsby,190000000,144840419,351040419,2013,206200000,thegreatgatsby20130510,the great gatsby2013
71,2009-11-06,disneyâs a christmas carol,190000000,137855863,315709697,2009,177853834,disneyâsachristmascarol20091106,disneyâs a christmas carol2009
72,2013-07-12,pacific rim,190000000,101802906,411002906,2013,309200000,pacificrim20130712,pacific rim2013
73,2015-11-25,the good dinosaur,187500000,123087120,333771037,2015,210683917,thegooddinosaur20151125,the good dinosaur2015
74,2008-05-02,iron man,186000000,318604126,585171547,2008,266567421,ironman20080502,iron man2008
75,2008-07-18,the dark knight,185000000,533720947,1001996207,2008,468275260,thedarkknight20080718,the dark knight2008
76,2008-05-22,indiana jones and the kingdom of the crystal skull,185000000,317101119,786635413,2008,469534294,indianajonesandthekingdomofthecrystalskull20080522,indiana jones and the kingdom of the crystal skull2008
77,2012-06-22,brave,185000000,237282182,554606532,2012,317324350,brave20120622,brave2012
78,2017-03-10,kong: skull island,185000000,168052812,561072059,2017,393019247,kongskullisland20170310,kong: skull island2017
79,2016-07-22,star trek beyond,185000000,158848340,335802233,2016,176953893,startrekbeyond20160722,star trek beyond2016
80,2017-10-06,blade runner 2049,185000000,92054159,259357408,2017,167303249,bladerunner204920171006,blade runner 20492017
81,2019-05-24,aladdin,182000000,246734314,619234314,2019,372500000,aladdin20190524,aladdin2019
82,2017-11-03,thor: ragnarok,180000000,315058289,846980024,2017,531921735,thorragnarok20171103,thor: ragnarok2017
83,2005-12-09,"the chronicles of narnia: the lion, the witch and the wardrobe",180000000,291710957,720539572,2005,428828615,thechroniclesofnarniathelionthewitchandthewardrobe20051209,"the chronicles of narnia: the lion, the witch and the wardrobe2005"
84,2014-05-30,maleficent,180000000,241407328,758536735,2014,517129407,maleficent20140530,maleficent2014
85,2016-11-18,fantastic beasts and where to find them,180000000,234037575,802402853,2016,568365278,fantasticbeastsandwheretofindthem20161118,fantastic beasts and where to find them2016
86,2008-06-27,wall-e,180000000,223808164,532508025,2008,308699861,walle20080627,wall-e2008
87,2007-08-10,rush hour 3,180000000,140125968,256585882,2007,116459914,rushhour320070810,rush hour 32007
88,2016-07-01,the legend of tarzan,180000000,126643061,348902025,2016,222258964,thelegendoftarzan20160701,the legend of tarzan2016
89,2011-11-23,hugo,180000000,73864507,180047784,2011,106183277,hugo20111123,hugo2011
90,2017-07-21,valerian and the city of a thousand planets,180000000,40479370,215098356,2017,174618986,valerianandthecityofathousandplanets20170721,valerian and the city of a thousand planets2017
91,2015-02-06,jupiter ascending,179000000,47482519,181982519,2015,134500000,jupiterascending20150206,jupiter ascending2015
92,2018-07-27,mission: impossibleâfallout,178000000,220159104,787456552,2018,567297448,missionimpossibleâfallout20180727,mission: impossibleâfallout2018
93,2016-05-27,x-men: apocalypse,178000000,155442489,542537546,2016,387095057,xmenapocalypse20160527,x-men: apocalypse2016
94,2018-08-10,the meg,178000000,145443742,529530715,2018,384086973,themeg20180810,the meg2018
95,2014-06-06,edge of tomorrow,178000000,100206256,370541256,2014,270335000,edgeoftomorrow20140606,edge of tomorrow2014
96,2019-03-08,captain marvel,175000000,426525952,1123061550,2019,696535598,captainmarvel20190308,captain marvel2019
97,2016-04-15,the jungle book,175000000,364001123,962854547,2016,598853424,thejunglebook20160415,the jungle book2016
98,2015-06-19,inside out,175000000,356461711,854235992,2015,497774281,insideout20150619,inside out2015
99,2017-07-07,spider-man: homecoming,175000000,334201140,880166350,2017,545965210,spidermanhomecoming20170707,spider-man: homecoming2017
100,2016-08-05,suicide squad,175000000,325100054,746059887,2016,420959833,suicidesquad20160805,suicide squad2016
1,2009-05-29,up,175000000,293004164,731463377,2009,438459213,up20090529,up2009
2,2017-11-22,coco,175000000,209726015,798008101,2017,588282086,coco20171122,coco2017
3,2018-11-21,ralph breaks the internet,175000000,201091711,524283695,2018,323191984,ralphbreakstheinternet20181121,ralph breaks the internet2018
4,2009-03-27,monsters vs. aliens,175000000,198351526,381687380,2009,183335854,monstersvsaliens20090327,monsters vs. aliens2009
5,2017-06-16,cars 3,175000000,152901115,383541369,2017,230640254,cars320170616,cars 32017
6,2009-08-07,g.i. joe: the rise of cobra,175000000,150201498,302469017,2009,152267519,gijoetheriseofcobra20090807,g.i. joe: the rise of cobra2009
8,2008-08-01,the mummy: tomb of the dragon emperor,175000000,102491776,405760225,2008,303268449,themummytombofthedragonemperor20080801,the mummy: tomb of the dragon emperor2008
9,2007-06-22,evan almighty,175000000,100289690,174131329,2007,73841639,evanalmighty20070622,evan almighty2007
11,2017-05-12,king arthur: legend of the sword,175000000,39175066,139630336,2017,100455270,kingarthurlegendofthesword20170512,king arthur: legend of the sword2017
12,2013-12-25,47 ronin,175000000,38362475,151716815,2013,113354340,47ronin20131225,47 ronin2013
13,2018-06-22,jurassic world: fallen kingdom,170000000,417719760,1305772799,2018,888053039,jurassicworldfallenkingdom20180622,jurassic world: fallen kingdom2018
14,2014-08-01,guardians of the galaxy,170000000,333172112,770867516,2014,437695404,guardiansofthegalaxy20140801,guardians of the galaxy2014
15,2010-05-07,iron man 2,170000000,312433331,621156389,2010,308723058,ironman220100507,iron man 22010
16,2014-04-04,captain america: the winter soldier,170000000,259746958,714401889,2014,454654931,captainamericathewintersoldier20140404,captain america: the winter soldier2014
17,2014-07-11,dawn of the planet of the apes,170000000,208545589,710644566,2014,502098977,dawnoftheplanetoftheapes20140711,dawn of the planet of the apes2014
18,2004-11-10,the polar express,170000000,187224605,311365187,2004,124140582,thepolarexpress20041110,the polar express2004
19,2012-06-01,snow white and the huntsman,170000000,155136755,401021746,2012,245884991,snowwhiteandthehuntsman20120601,snow white and the huntsman2012
20,2003-07-01,terminator 3: rise of the machines,170000000,150358296,433058296,2003,282700000,terminator3riseofthemachines20030701,terminator 3: rise of the machines2003
21,2004-05-07,van helsing,170000000,120150546,300150546,2004,180000000,vanhelsing20040507,van helsing2004
22,2019-03-29,dumbo,170000000,113883318,345004422,2019,231121104,dumbo20190329,dumbo2019
23,2015-05-22,tomorrowland,170000000,93436322,206627518,2015,113191196,tomorrowland20150522,tomorrowland2015
24,2019-02-14,alita: battle angel,170000000,85710210,402976036,2019,317265826,alitabattleangel20190214,alita: battle angel2019
25,2019-05-31,godzilla: king of the monsters,170000000,85576941,299276941,2019,213700000,godzillakingofthemonsters20190531,godzilla: king of the monsters2019
26,2016-05-27,alice through the looking glass,170000000,77042381,276928112,2016,199885731,alicethroughthelookingglass20160527,alice through the looking glass2016
27,2010-05-21,shrek forever after,165000000,238736787,756244673,2010,517507886,shrekforeverafter20100521,shrek forever after2010
28,2016-11-04,doctor strange,165000000,232641920,676404566,2016,443762646,doctorstrange20161104,doctor strange2016
29,2014-11-07,big hero 6,165000000,222527828,652127828,2014,429600000,bighero620141107,big hero 62014
30,2010-03-26,how to train your dragon,165000000,217581232,494870992,2010,277289760,howtotrainyourdragon20100326,how to train your dragon2010
31,2012-11-02,wreck-it ralph,165000000,189412677,496511521,2012,307098844,wreckitralph20121102,wreck-it ralph2012
32,2014-11-05,interstellar,165000000,188017894,666379375,2014,478361481,interstellar20141105,interstellar2014
33,2016-06-24,independence day: resurgence,165000000,103144286,384169424,2016,281025138,independencedayresurgence20160624,independence day: resurgence2016
34,2011-07-29,cowboys and aliens,163000000,100368560,176038324,2011,75669764,cowboysandaliens20110729,cowboys and aliens2011
35,2017-03-17,beauty and the beast,160000000,504014165,1259199706,2017,755185541,beautyandthebeast20170317,beauty and the beast2017
36,2018-12-21,aquaman,160000000,335061807,1146894640,2018,811832833,aquaman20181221,aquaman2018
37,2007-05-17,shrek the third,160000000,322719944,807330936,2007,484610992,shrekthethird20070517,shrek the third2007
38,2010-07-16,inception,160000000,292576195,835524642,2010,542948447,inception20100716,inception2010
39,2015-11-20,the hunger games: mockingjay - part 2,160000000,281723902,648986787,2015,367262885,thehungergamesmockingjaypart220151120,the hunger games: mockingjay - part 22015
40,2013-05-24,fast and furious 6,160000000,238679850,789300444,2013,550620594,fastandfurious620130524,fast and furious 62013
41,2014-05-16,godzilla,160000000,200676069,529076069,2014,328400000,godzilla20140516,godzilla2014
42,2011-06-03,x-men: first class,160000000,146408305,355408305,2011,209000000,xmenfirstclass20110603,x-men: first class2011
43,2008-12-25,the curious case of benjamin button,160000000,127509326,329631958,2008,202122632,thecuriouscaseofbenjaminbutton20081225,the curious case of benjamin button2008
44,2010-07-14,the sorcerer's apprentice,160000000,63150991,217986320,2010,154835329,thesorcerersapprentice20100714,the sorcerer's apprentice2010
45,2006-05-12,poseidon,160000000,60674817,181674817,2006,121000000,poseidon20060512,poseidon2006
46,2016-06-10,warcraft,160000000,47225655,425522281,2016,378296626,warcraft20160610,warcraft2016
47,2016-09-30,deepwater horizon,156000000,61433527,122603824,2016,61170297,deepwaterhorizon20160930,deepwater horizon2016
48,2010-12-10,the chronicles of narnia: the voyage of the dawn treader,155000000,104386950,418186950,2010,313800000,thechroniclesofnarniathevoyageofthedawntreader20101210,the chronicles of narnia: the voyage of the dawn treader2010
49,2015-07-01,terminator: genisys,155000000,89760956,432150894,2015,342389938,terminatorgenisys20150701,terminator: genisys2015
50,2018-03-23,pacific rim: uprising,155000000,59874525,290930148,2018,231055623,pacificrimuprising20180323,pacific rim: uprising2018
51,2004-11-24,alexander,155000000,34297191,167297191,2004,133000000,alexander20041124,alexander2004
52,2017-07-14,war for the planet of the apes,152000000,146880162,489592267,2017,342712105,warfortheplanetoftheapes20170714,war for the planet of the apes2017
53,2001-05-25,pearl harbor,151500000,198539855,449239855,2001,250700000,pearlharbor20010525,pearl harbor2001
54,2007-07-02,transformers,151000000,319246193,708272592,2007,389026399,transformers20070702,transformers2007
55,2017-06-02,wonder woman,150000000,412563408,821133378,2017,408569970,wonderwoman20170602,wonder woman2017
56,2013-11-22,frozen,150000000,400738009,1272469910,2013,871731901,frozen20131122,frozen2013
57,2016-03-04,zootopia,150000000,341268248,1019429616,2016,678161368,zootopia20160304,zootopia2016
58,2007-07-11,harry potter and the order of the phoenix,150000000,292137260,943076457,2007,650939197,harrypotterandtheorderofthephoenix20070711,harry potter and the order of the phoenix2007
59,2005-11-18,harry potter and the goblet of fire,150000000,290201752,897099794,2005,606898042,harrypotterandthegobletoffire20051118,harry potter and the goblet of fire2005
60,2003-05-15,the matrix reloaded,150000000,281553689,738576929,2003,457023240,thematrixreloaded20030515,the matrix reloaded2003
61,2007-12-14,i am legend,150000000,256393010,585532684,2007,329139674,iamlegend20071214,i am legend2007
62,2016-11-23,moana,150000000,248757044,637517365,2016,388760321,moana20161123,moana2016
63,2008-07-01,hancock,150000000,227946274,624234272,2008,396287998,hancock20080701,hancock2008
64,2005-07-15,charlie and the chocolate factory,150000000,206459076,475825484,2005,269366408,charlieandthechocolatefactory20050715,charlie and the chocolate factory2005
65,2007-06-29,ratatouille,150000000,206445654,626549695,2007,420104041,ratatouille20070629,ratatouille2007
66,2013-11-08,thor: the dark world,150000000,206362140,644602516,2013,438240376,thorthedarkworld20131108,thor: the dark world2013
67,2005-06-15,batman begins,150000000,205343774,359142722,2005,153798948,batmanbegins20050615,batman begins2005
68,2015-07-31,mission: impossibleârogue nation,150000000,195042377,688858992,2015,493816615,missionimpossibleâroguenation20150731,mission: impossibleârogue nation2015
69,2017-07-21,dunkirk,150000000,190068280,499837368,2017,309769088,dunkirk20170721,dunkirk2017
70,2011-05-06,thor,150000000,181030624,449326618,2011,268295994,thor20110506,thor2011
71,2008-11-07,madagascar: escape 2 africa,150000000,180174880,599680774,2008,419505894,madagascarescape2africa20081107,madagascar: escape 2 africa2008
72,2009-05-01,x-men origins: wolverine,150000000,179883157,374825760,2009,194942603,xmenoriginswolverine20090501,x-men origins: wolverine2009
73,2009-05-22,night at the museum: battle of the smithsonian,150000000,177243721,402231063,2009,224987342,nightatthemuseumbattleofthesmithsonian20090522,night at the museum: battle of the smithsonian2009
74,2011-05-26,kung fu panda 2,150000000,165249063,664837547,2011,499588484,kungfupanda220110526,kung fu panda 22011
75,2015-05-15,mad max: fury road,150000000,153636354,370098020,2015,216461666,madmaxfuryroad20150515,mad max: fury road2015
76,2019-05-10,pokã©mon: detective pikachu,150000000,139507806,411258433,2019,271750627,pokãmondetectivepikachu20190510,pokã©mon: detective pikachu2019
77,2003-11-05,the matrix revolutions,150000000,139270910,427300260,2003,288029350,thematrixrevolutions20031105,the matrix revolutions2003
78,2018-03-29,ready player one,150000000,137690172,579290136,2018,441599964,readyplayerone20180329,ready player one2018
79,2005-11-04,chicken little,150000000,135386665,310043823,2005,174657158,chickenlittle20051104,chicken little2005
80,2006-05-05,mission: impossible iii,150000000,133501348,397501348,2006,264000000,missionimpossibleiii20060505,mission: impossible iii2006
81,2009-05-15,angels & demons,150000000,133375846,490875846,2009,357500000,angelsdemons20090515,angels & demons2009
82,2004-05-14,troy,150000000,133298577,484161265,2004,350862688,troy20040514,troy2004
83,2010-07-01,the last airbender,150000000,131772187,319713881,2010,187941694,thelastairbender20100701,the last airbender2010
84,2007-11-02,bee movie,150000000,126631277,287594577,2007,160963300,beemovie20071102,bee movie2007
85,2009-07-24,g-force,150000000,119436770,292817841,2009,173381071,gforce20090724,g-force2009
86,2008-11-21,bolt,150000000,114053579,328015029,2008,213961450,bolt20081121,bolt2008
87,2012-03-30,wrath of the titans,150000000,83670083,305270083,2012,221600000,wrathofthetitans20120330,wrath of the titans2012
88,2007-11-16,beowulf,150000000,82280579,195080579,2007,112800000,beowulf20071116,beowulf2007
89,2012-05-11,dark shadows,150000000,79727149,238202668,2012,158475519,darkshadows20120511,dark shadows2012
90,2013-06-28,white house down,150000000,73103784,205440387,2013,132336603,whitehousedown20130628,white house down2013
91,2010-02-12,the wolfman,150000000,62189884,142634358,2010,80444474,thewolfman20100212,the wolfman2010
92,2017-02-17,the great wall,150000000,45157105,334486852,2017,289329747,thegreatwall20170217,the great wall2017
93,2015-10-09,pan,150000000,35088320,151525973,2015,116437653,pan20151009,pan2015
94,2011-03-11,mars needs moms,150000000,21392758,39549758,2011,18157000,marsneedsmoms20110311,mars needs moms2011
95,2020-12-31,moonfall,150000000,0,0,2020,0,moonfall20201231,moonfall2020
96,2006-11-03,flushed away,149000000,64665672,179357126,2006,114691454,flushedaway20061103,flushed away2006
97,2012-06-08,madagascar 3: europe's most wanted,145000000,216391482,746921271,2012,530529789,madagascar3europesmostwanted20120608,madagascar 3: europe's most wanted2012
98,2011-12-16,mission: impossibleâghost protocol,145000000,209397903,694713230,2011,485315327,missionimpossibleâghostprotocol20111216,mission: impossibleâghost protocol2011
99,2014-06-13,how to train your dragon 2,145000000,177002924,614586270,2014,437583346,howtotrainyourdragon220140613,how to train your dragon 22014
1,2014-03-07,mr. peabody & sherman,145000000,111506430,269806430,2014,158300000,mrpeabodysherman20140307,mr. peabody & sherman2014
2,2012-11-21,rise of the guardians,145000000,103412758,306900902,2012,203488144,riseoftheguardians20121121,rise of the guardians2012
3,2005-04-08,sahara,145000000,68671925,121671925,2005,53000000,sahara20050408,sahara2005
4,2016-07-15,ghostbusters,144000000,128350574,229008658,2016,100658084,ghostbusters20160715,ghostbusters2016
5,2002-11-22,die another day,142000000,160942139,431942139,2002,271000000,dieanotherday20021122,die another day2002
6,2003-07-09,pirates of the caribbean: the curse of the black pearl,140000000,305411224,634954103,2003,329542879,piratesofthecaribbeanthecurseoftheblackpearl20030709,pirates of the caribbean: the curse of the black pearl2003
7,2009-05-08,star trek,140000000,257730019,386839614,2009,129109595,startrek20090508,star trek2009
9,2002-07-03,men in black 2,140000000,190418803,441767803,2002,251349000,meninblack220020703,men in black 22002
10,2011-07-22,captain america: the first avenger,140000000,176654505,370569776,2011,193915271,captainamericathefirstavenger20110722,captain america: the first avenger2011
11,2016-01-29,kung fu panda 3,140000000,143528619,517599142,2016,374070523,kungfupanda320160129,kung fu panda 32016
13,2013-03-27,g.i. joe: retaliation,140000000,122523060,375740705,2013,253217645,gijoeretaliation20130327,g.i. joe: retaliation2013
14,2003-12-05,the last samurai,140000000,111110575,456810575,2003,345700000,thelastsamurai20031205,the last samurai2003
15,2005-12-21,fun with dick and jane,140000000,110550000,203018919,2005,92468919,funwithdickandjane20051221,fun with dick and jane2005
16,2014-12-12,exodus: gods and kings,140000000,65014513,268314513,2014,203300000,exodusgodsandkings20141212,exodus: gods and kings2014
17,2016-07-01,the bfg,140000000,55483770,199646680,2016,144162910,thebfg20160701,the bfg2016
18,2016-02-26,gods of egypt,140000000,31153464,138836756,2016,107683292,godsofegypt20160226,gods of egypt2016
19,2002-05-03,spider-man,139000000,403706375,821706375,2002,418000000,spiderman20020503,spider-man2002
20,2009-03-06,watchmen,138000000,107509799,186976250,2009,79466451,watchmen20090306,watchmen2009
21,2005-07-29,stealth,138000000,32116746,76416746,2005,44300000,stealth20050729,stealth2005
22,2008-06-13,the incredible hulk,137500000,134806913,265573859,2008,130766946,theincrediblehulk20080613,the incredible hulk2008
23,2003-06-20,hulk,137000000,132177234,245075434,2003,112898200,hulk20030620,hulk2003
24,2001-07-11,final fantasy: the spirits within,137000000,32131830,85131830,2001,53000000,finalfantasythespiritswithin20010711,final fantasy: the spirits within2001
25,2012-11-16,"the twilight saga: breaking dawn, part 2",136200000,292324737,829724737,2012,537400000,thetwilightsagabreakingdawnpart220121116,"the twilight saga: breaking dawn, part 22012"
26,2013-03-22,the croods,135000000,187168425,573068425,2013,385900000,thecroods20130322,the croods2013
27,2015-12-25,the revenant,135000000,183637894,532938302,2015,349300408,therevenant20151225,the revenant2015
29,2011-03-04,rango,135000000,123477607,245724600,2011,122246993,rango20110304,rango2011
30,2003-11-14,master and commander: the far side of the world,135000000,93926386,212912137,2003,118985751,masterandcommanderthefarsideoftheworld20031114,master and commander: the far side of the world2003
31,2013-07-17,turbo,135000000,83028130,286896578,2013,203868448,turbo20130717,turbo2013
32,2016-06-03,teenage mutant ninja turtles: out of the shadows,135000000,82051601,245328374,2016,163276773,teenagemutantninjaturtlesoutoftheshadows20160603,teenage mutant ninja turtles: out of the shadows2016
33,2011-11-18,happy feet two,135000000,64006466,157956466,2011,93950000,happyfeettwo20111118,happy feet two2011
34,2006-07-28,miami vice,135000000,63478838,163818556,2006,100339718,miamivice20060728,miami vice2006
35,2018-11-02,the nutcracker and the four realms,132900000,54858851,170293899,2018,115435048,thenutcrackerandthefourrealms20181102,the nutcracker and the four realms2018
36,2005-06-29,war of the worlds,132000000,234280354,606836535,2005,372556181,waroftheworlds20050629,war of the worlds2005
37,2014-11-26,penguins of madagascar,132000000,83350911,366942531,2014,283591620,penguinsofmadagascar20141126,penguins of madagascar2014
38,2013-11-22,the hunger games: catching fire,130000000,424668047,864868047,2013,440200000,thehungergamescatchingfire20131122,the hunger games: catching fire2013
39,2004-06-04,harry potter and the prisoner of azkaban,130000000,249757726,796907323,2004,547149597,harrypotterandtheprisonerofazkaban20040604,harry potter and the prisoner of azkaban2004
40,2007-08-03,the bourne ultimatum,130000000,227471070,444043396,2007,216572326,thebourneultimatum20070803,the bourne ultimatum2007
41,2018-07-06,ant-man and the wasp,130000000,216648740,623144660,2018,406495920,antmanandthewasp20180706,ant-man and the wasp2018
42,2008-06-06,kung fu panda,130000000,215434591,631910531,2008,416475940,kungfupanda20080606,kung fu panda2008
43,2015-07-17,ant-man,130000000,180202163,518858449,2015,338656286,antman20150717,ant-man2015
44,2015-03-27,home,130000000,177397510,385997896,2015,208600386,home20150327,home2015
45,2018-12-19,mary poppins returns,130000000,171958438,341528518,2018,169570080,marypoppinsreturns20181219,mary poppins returns2018
46,2011-10-28,puss in boots,130000000,149260504,554987477,2011,405726973,pussinboots20111028,puss in boots2011
47,2010-11-05,megamind,130000000,148415853,321887208,2010,173471355,megamind20101105,megamind2010
48,2003-07-18,bad boys ii,130000000,138540870,273271982,2003,134731112,badboysii20030718,bad boys ii2003
49,2014-04-11,rio 2,130000000,131538435,492846291,2014,361307856,rio220140411,rio 22014
50,2010-07-23,salt,130000000,118311368,290650494,2010,172339126,salt20100723,salt2010
51,2014-03-28,noah,130000000,101200044,352831065,2014,251631021,noah20140328,noah2014
52,2011-12-21,the adventures of tintin,130000000,77591831,373993951,2011,296402120,theadventuresoftintin20111221,the adventures of tintin2011
53,2013-05-31,after earth,130000000,60522097,251499665,2013,190977568,afterearth20130531,after earth2013
54,2008-11-26,australia,130000000,49554002,215080810,2008,165526808,australia20081126,australia2008
55,2013-07-19,r.i.p.d.,130000000,33618855,79076678,2013,45457823,ripd20130719,r.i.p.d.2013
56,2019-02-22,how to train your dragon: the hidden world,129000000,160791800,519258283,2019,358466483,howtotrainyourdragonthehiddenworld20190222,how to train your dragon: the hidden world2019
57,2011-11-18,"the twilight saga: breaking dawn, part 1",127500000,281287133,689420051,2011,408132918,thetwilightsagabreakingdawnpart120111118,"the twilight saga: breaking dawn, part 12011"
58,2000-05-19,dinosaur,127500000,137748063,356148063,2000,218400000,dinosaur20000519,dinosaur2000
59,2017-03-03,logan,127000000,226277068,615461394,2017,389184326,logan20170303,logan2017
60,2014-12-19,night at the museum: secret of the tomb,127000000,113746621,353756621,2014,240010000,nightatthemuseumsecretofthetomb20141219,night at the museum: secret of the tomb2014
61,2011-07-15,harry potter and the deathly hallows: part ii,125000000,381193157,1341693157,2011,960500000,harrypotterandthedeathlyhallowspartii20110715,harry potter and the deathly hallows: part ii2011
62,2014-11-21,the hunger games: mockingjay - part 1,125000000,337135885,766575131,2014,429439246,thehungergamesmockingjaypart120141121,the hunger games: mockingjay - part 12014
63,2001-11-16,harry potter and the sorcererâs stone,125000000,317871467,975047606,2001,657176139,harrypotterandthesorcererâsstone20011116,harry potter and the sorcererâs stone2001
64,2010-11-19,harry potter and the deathly hallows: part i,125000000,296131568,960431568,2010,664300000,harrypotterandthedeathlyhallowsparti20101119,harry potter and the deathly hallows: part i2010
65,2006-05-19,the da vinci code,125000000,217536138,767820459,2006,550284321,thedavincicode20060519,the da vinci code2006
66,2003-05-02,x-men 2,125000000,214949694,406875536,2003,191925842,xmen220030502,x-men 22003
67,2011-04-29,fast five,125000000,210031325,630163454,2011,420132129,fastfive20110429,fast five2011
68,2014-08-08,teenage mutant ninja turtles,125000000,191204754,485004754,2014,293800000,teenagemutantninjaturtles20140808,teenage mutant ninja turtles2014
69,2011-12-16,sherlock holmes: a game of shadows,125000000,186848418,535663443,2011,348815025,sherlockholmesagameofshadows20111216,sherlock holmes: a game of shadows2011
70,2004-05-28,the day after tomorrow,125000000,186740799,556319450,2004,369578651,thedayaftertomorrow20040528,the day after tomorrow2004
71,2017-03-31,the boss baby,125000000,175003033,510878762,2017,335875729,thebossbaby20170331,the boss baby2017
72,2010-04-01,clash of the titans,125000000,163214888,493214888,2010,330000000,clashofthetitans20100401,clash of the titans2010
73,2016-11-04,trolls,125000000,153707064,344150134,2016,190443070,trolls20161104,trolls2016
75,2012-06-08,prometheus,125000000,126477084,402448265,2012,275971181,prometheus20120608,prometheus2012
76,2012-08-10,the bourne legacy,125000000,113203870,280355920,2012,167152050,thebournelegacy20120810,the bourne legacy2012
78,2018-07-13,skyscraper,125000000,68420120,304115534,2018,235695414,skyscraper20180713,skyscraper2018
79,2012-08-03,total recall,125000000,58877969,211856088,2012,152978119,totalrecall20120803,total recall2012
80,2016-12-21,assassinâs creed,125000000,54647948,240759682,2016,186111734,assassinâscreed20161221,assassinâs creed2016
81,2017-01-13,monster trucks,125000000,33370166,61642798,2017,28272632,monstertrucks20170113,monster trucks2017
83,2000-11-17,how the grinch stole christmas,123000000,260044825,345141403,2000,85096578,howthegrinchstolechristmas20001117,how the grinch stole christmas2000
84,2000-05-24,mission: impossible 2,120000000,215409889,549588516,2000,334178627,missionimpossible220000524,mission: impossible 22000
85,2000-06-30,the perfect storm,120000000,182618434,328711434,2000,146093000,theperfectstorm20000630,the perfect storm2000
86,2016-07-29,jason bourne,120000000,162192920,416168316,2016,253975396,jasonbourne20160729,jason bourne2016
87,2007-06-15,fantastic four: rise of the silver surfer,120000000,131921738,289480691,2007,157558953,fantasticfourriseofthesilversurfer20070615,fantastic four: rise of the silver surfer2007
88,2012-11-21,life of pi,120000000,124987022,620912003,2012,495924981,lifeofpi20121121,life of pi2012
89,2007-02-16,ghost rider,120000000,115802596,229545589,2007,113742993,ghostrider20070216,ghost rider2007
90,2018-04-13,rampage,120000000,101028233,428056280,2018,327028047,rampage20180413,rampage2018
91,2003-06-27,charlie's angels: full throttle,120000000,100814328,227200000,2003,126385672,charliesangelsfullthrottle20030627,charlie's angels: full throttle2003
92,2013-08-09,elysium,120000000,93050117,286192091,2013,193141974,elysium20130809,elysium2013
93,2013-04-19,oblivion,120000000,89107235,287916633,2013,198809398,oblivion20130419,oblivion2013
94,2017-03-24,power rangers,120000000,85364450,142531552,2017,57167102,powerrangers20170324,power rangers2017
95,2002-07-19,stuart little 2,120000000,64956806,166000000,2002,101043194,stuartlittle220020719,stuart little 22002
96,2014-02-12,robocop,120000000,58607007,242981799,2014,184374792,robocop20140212,robocop2014
97,2004-06-11,the chronicles of riddick,120000000,57712751,107212751,2004,49500000,thechroniclesofriddick20040611,the chronicles of riddick2004
98,2015-08-07,fantastic four,120000000,56117548,167849187,2015,111731639,fantasticfour20150807,fantastic four2015
99,2008-05-09,speed racer,120000000,43945766,93394462,2008,49448696,speedracer20080509,speed racer2008
100,2005-07-22,the island,120000000,35818913,163018913,2005,127200000,theisland20050722,the island2005
1,2010-12-17,how do you know?,120000000,30212620,49628177,2010,19415557,howdoyouknow20101217,how do you know?2010
2,2010-06-23,knight and day,117000000,76423035,258751370,2010,182328335,knightandday20100623,knight and day2010
3,2018-10-05,venom,116000000,213511408,853628605,2018,640117197,venom20181005,venom2018
5,2005-05-19,star wars ep. iii: revenge of the sith,115000000,380270577,848998877,2005,468728300,starwarsepiiirevengeofthesith20050519,star wars ep. iii: revenge of the sith2005
6,2002-05-16,star wars ep. ii: attack of the clones,115000000,310676740,656695615,2002,346018875,starwarsepiiattackoftheclones20020516,star wars ep. ii: attack of the clones2002
7,2001-11-02,"monsters, inc.",115000000,289423425,559757719,2001,270334294,monstersinc20011102,"monsters, inc.2001"
8,2013-07-26,the wolverine,115000000,132556852,416456852,2013,283900000,thewolverine20130726,the wolverine2013
10,2016-04-22,the huntsman: winterâs war,115000000,48003015,165149302,2016,117146287,thehuntsmanwinterâswar20160422,the huntsman: winterâs war2016
11,2002-06-14,windtalkers,115000000,40914068,77628265,2002,36714197,windtalkers20020614,windtalkers2002
12,2008-07-04,astã©rix aux jeux olympiques,113500000,999811,132999811,2008,132000000,astãrixauxjeuxolympiques20080704,astã©rix aux jeux olympiques2008
13,2010-12-25,gulliver's travels,112000000,42779261,232017848,2010,189238587,gulliverstravels20101225,gulliver's travels2010
14,2017-12-15,ferdinand,111000000,84410380,289847930,2017,205437550,ferdinand20171215,ferdinand2017
15,2018-05-18,deadpool 2,110000000,324591735,786680557,2018,462088822,deadpool220180518,deadpool 22018
16,2013-10-04,gravity,110000000,274092705,693698673,2013,419605968,gravity20131004,gravity2013
17,2006-12-22,night at the museum,110000000,250863268,579446407,2006,328583139,nightatthemuseum20061222,night at the museum2006
18,2005-06-10,mr. and mrs. smith,110000000,186336279,486124090,2005,299787811,mrandmrssmith20050610,mr. and mrs. smith2005
19,2015-05-29,san andreas,110000000,155190832,456258539,2015,301067707,sanandreas20150529,san andreas2015
20,2011-07-29,the smurfs,110000000,142614158,563749323,2011,421135165,thesmurfs20110729,the smurfs2011
21,2007-06-27,live free or die hard,110000000,134529403,382288147,2007,247758744,livefreeordiehard20070627,live free or die hard2007
22,2015-03-20,the divergent series: insurgent,110000000,130179072,295075882,2015,164896810,thedivergentseriesinsurgent20150320,the divergent series: insurgent2015
23,2004-12-10,ocean's twelve,110000000,125531634,362989076,2004,237457442,oceanstwelve20041210,ocean's twelve2004
25,2000-06-28,the patriot,110000000,113330342,215300000,2000,101969658,thepatriot20000628,the patriot2000
26,2014-03-07,300: rise of an empire,110000000,106580051,330780051,2014,224200000,300riseofanempire20140307,300: rise of an empire2014
27,2004-12-17,the aviator,110000000,102608827,208370892,2004,105762065,theaviator20041217,the aviator2004
28,2016-12-21,passengers,110000000,100014699,302239672,2016,202224973,passengers20161221,passengers2016
29,2011-01-14,the green hornet,110000000,98780042,229155503,2011,130375461,thegreenhornet20110114,the green hornet2011
30,2016-09-30,miss peregrineâs home for peculiar children,110000000,87242834,295986876,2016,208744042,missperegrineâshomeforpeculiarchildren20160930,miss peregrineâs home for peculiar children2016
31,2011-10-07,real steel,110000000,85463309,263880341,2011,178417032,realsteel20111007,real steel2011
32,2010-06-11,the a-team,110000000,77222099,177241171,2010,100019072,theateam20100611,the a-team2010
33,2013-07-31,the smurfs 2,110000000,71017784,348547523,2013,277529739,thesmurfs220130731,the smurfs 22013
34,2016-03-18,the divergent series: allegiant,110000000,66184051,172022517,2016,105838466,thedivergentseriesallegiant20160318,the divergent series: allegiant2016
35,2009-06-12,the taking of pelham 123,110000000,65452312,152364370,2009,86912058,thetakingofpelham12320090612,the taking of pelham 1232009
36,2013-11-01,ender's game,110000000,61737191,127983283,2013,66246092,endersgame20131101,ender's game2013
37,2004-04-02,home on the range,110000000,50026353,76482461,2004,26456108,homeontherange20040402,home on the range2004
39,2005-05-06,kingdom of heaven,110000000,47398413,218853353,2005,171454940,kingdomofheaven20050506,kingdom of heaven2005
40,2017-03-31,ghost in the shell,110000000,40563557,167910690,2017,127347133,ghostintheshell20170331,ghost in the shell2017
41,2004-06-16,around the world in 80 days,110000000,24004159,72004159,2004,48000000,aroundtheworldin80days20040616,around the world in 80 days2004
42,2019-06-14,men in black: international,110000000,3100000,3100000,2019,0,meninblackinternational20190614,men in black: international2019
43,2001-12-19,the lord of the rings: the fellowship of the ring,109000000,315544750,887210985,2001,571666235,thelordoftheringsthefellowshipofthering20011219,the lord of the rings: the fellowship of the ring2001
44,2003-11-21,the cat in the hat,109000000,101018283,133818283,2003,32800000,thecatinthehat20031121,the cat in the hat2003
45,2001-12-25,ali,109000000,58183966,87683966,2001,29500000,ali20011225,ali2001
46,2015-10-02,the martian,108000000,228433663,655271443,2015,426837780,themartian20151002,the martian2015
47,2016-11-23,allied,106000000,40098064,119266661,2016,79168597,allied20161123,allied2016
48,2004-07-16,"i, robot",105000000,144801023,348629585,2004,203828562,irobot20040716,"i, robot2004"
50,2009-11-25,the princess and the frog,105000000,104400899,270997378,2009,166596479,theprincessandthefrog20091125,the princess and the frog2009
51,2008-03-07,"10,000 b.c.",105000000,94784201,269065678,2008,174281477,10000bc20080307,"10,000 b.c.2008"
52,2016-07-22,ice age: collision course,105000000,64063008,402156682,2016,338093674,iceagecollisioncourse20160722,ice age: collision course2016
53,2001-04-27,town & country,105000000,6712451,10364769,2001,3652318,towncountry20010427,town & country2001
54,2017-09-22,kingsman: the golden circle,104000000,100234838,408803696,2017,308568858,kingsmanthegoldencircle20170922,kingsman: the golden circle2017
55,2000-06-09,gone in 60 seconds,103300000,101643008,232643008,2000,131000000,gonein60seconds20000609,gone in 60 seconds2000
56,2000-05-05,gladiator,103000000,187683805,457683805,2000,270000000,gladiator20000505,gladiator2000
57,2013-05-23,the hangover 3,103000000,112200072,362000072,2013,249800000,thehangover320130523,the hangover 32013
58,2018-03-09,a wrinkle in time,103000000,100478608,133401882,2018,32923274,awrinkleintime20180309,a wrinkle in time2018
59,2009-07-01,public enemies,102500000,97104620,212282709,2009,115178089,publicenemies20090701,public enemies2009
60,2006-11-17,casino royale,102000000,167365000,594420283,2006,427055283,casinoroyale20061117,casino royale2006
61,2002-06-21,minority report,102000000,132024714,358824714,2002,226800000,minorityreport20020621,minority report2002
62,2018-12-21,bumblebee,102000000,127195589,465195589,2018,338000000,bumblebee20181221,bumblebee2018
63,2012-10-26,cloud atlas,102000000,27108272,130673154,2012,103564882,cloudatlas20121026,cloud atlas2012
64,2002-11-15,harry potter and the chamber of secrets,100000000,262233381,879225135,2002,616991754,harrypotterandthechamberofsecrets20021115,harry potter and the chamber of secrets2002
67,2001-07-27,planet of the apes,100000000,180011740,362211740,2001,182200000,planetoftheapes20010727,planet of the apes2001
68,2004-11-19,national treasure,100000000,173005002,331323410,2004,158318408,nationaltreasure20041119,national treasure2004
69,2012-12-25,django unchained,100000000,162805434,449948323,2012,287142889,djangounchained20121225,django unchained2012
70,2010-12-22,little fockers,100000000,148438600,310650574,2010,162211974,littlefockers20101222,little fockers2010
72,2007-11-02,american gangster,100000000,130164645,267985456,2007,137820811,americangangster20071102,american gangster2007
73,2009-09-18,cloudy with a chance of meatballs,100000000,124870275,236827677,2009,111957402,cloudywithachanceofmeatballs20090918,cloudy with a chance of meatballs2009
74,2010-08-06,the other guys,100000000,119219978,170936470,2010,51716492,theotherguys20100806,the other guys2010
75,2004-12-17,lemony snicket's a series of unfortunate events,100000000,118627117,212956024,2004,94328907,lemonysnicketsaseriesofunfortunateevents20041217,lemony snicket's a series of unfortunate events2004
76,2013-12-25,the wolf of wall street,100000000,116900694,389870414,2013,272969720,thewolfofwallstreet20131225,the wolf of wall street2013
77,2013-05-24,epic,100000000,107518682,262794441,2013,155275759,epic20130524,epic2013
80,2000-12-15,the emperor's new groove,100000000,89296573,169296573,2000,80000000,theemperorsnewgroove20001215,the emperor's new groove2000
81,2012-08-17,the expendables 2,100000000,85028192,311979256,2012,226951064,theexpendables220120817,the expendables 22012
82,2009-10-16,where the wild things are,100000000,77233467,99123656,2009,21890189,wherethewildthingsare20091016,where the wild things are2009
83,2006-12-15,eragon,100000000,75030163,249488115,2006,174457952,eragon20061215,eragon2006
84,2014-07-25,hercules,100000000,72688614,243388614,2014,170700000,hercules20140725,hercules2014
85,2010-12-10,the tourist,100000000,67631157,278731369,2010,211100212,thetourist20101210,the tourist2010
87,2004-06-11,the stepford wives,100000000,59475623,96221971,2004,36746348,thestepfordwives20040611,the stepford wives2004
88,2007-06-08,surf's up,100000000,58867694,145395745,2007,86528051,surfsup20070608,surf's up2007
89,2006-12-08,blood diamond,100000000,57377916,171377916,2006,114000000,blooddiamond20061208,blood diamond2006
90,2010-09-24,legend of the guardians: the owls of ga'hoole,100000000,55675313,139716717,2010,84041404,legendoftheguardianstheowlsofgahoole20100924,legend of the guardians: the owls of ga'hoole2010
92,2009-06-05,land of the lost,100000000,49438370,69548641,2009,20110271,landofthelost20090605,land of the lost2009
93,2003-12-25,peter pan,100000000,48417850,95255485,2003,46837635,peterpan20031225,peter pan2003
94,2019-03-15,wonder park,100000000,45216793,115149422,2019,69932629,wonderpark20190315,wonder park2019
95,2004-07-23,catwoman,100000000,40202379,82145379,2004,41943000,catwoman20040723,catwoman2004
96,2014-08-15,the expendables 3,100000000,39322544,209461378,2014,170138834,theexpendables320140815,the expendables 32014
97,2002-11-27,treasure planet,100000000,38120554,91800000,2002,53679446,treasureplanet20021127,treasure planet2002
98,2010-03-12,green zone,100000000,35497337,97523020,2010,62025683,greenzone20100312,green zone2010
99,2017-10-20,geostorm,100000000,33700160,220796009,2017,187095849,geostorm20171020,geostorm2017
100,2015-12-25,point break,100000000,28782481,126704591,2015,97922110,pointbreak20151225,point break2015
1,2015-12-11,in the heart of the sea,100000000,25020758,89693309,2015,64672551,intheheartofthesea20151211,in the heart of the sea2015
2,2014-04-18,transcendence,100000000,23022309,103039258,2014,80016949,transcendence20140418,transcendence2014
3,2005-02-18,son of the mask,100000000,17018422,59918422,2005,42900000,sonofthemask20050218,son of the mask2005
4,2018-12-14,mortal engines,100000000,15951040,85287417,2018,69336377,mortalengines20181214,mortal engines2018
5,2002-08-16,the adventures of pluto nash,100000000,4411102,7094995,2002,2683893,theadventuresofplutonash20020816,the adventures of pluto nash2002
6,2012-01-20,jin lã­ng shã­ san chai,100000000,311434,98227017,2012,97915583,jinlãngshãsanchai20120120,jin lã­ng shã­ san chai2012
7,2015-11-06,the peanuts movie,99000000,130178411,250091610,2015,119913199,thepeanutsmovie20151106,the peanuts movie2015
8,2019-02-08,the lego movie 2: the second part,99000000,105806508,190325698,2019,84519190,thelegomovie2thesecondpart20190208,the lego movie 2: the second part2019
9,2018-11-21,robin hood,99000000,30824628,84747441,2018,53922813,robinhood20181121,robin hood2018
10,2001-05-04,the mummy returns,98000000,202007640,435040395,2001,233032755,themummyreturns20010504,the mummy returns2001
11,2002-12-20,gangs of new york,97000000,77730500,183124621,2002,105394121,gangsofnewyork20021220,gangs of new york2002
12,2017-05-19,alien: covenant,97000000,74262031,238521247,2017,164259216,aliencovenant20170519,alien: covenant2017
13,2015-03-13,cinderella,95000000,201151353,534551353,2015,333400000,cinderella20150313,cinderella2015
14,2012-07-13,ice age: continental drift,95000000,161321843,879765137,2012,718443294,iceagecontinentaldrift20120713,ice age: continental drift2012
15,2001-12-28,black hawk down,95000000,108638745,159691085,2001,51052340,blackhawkdown20011228,black hawk down2001
16,2010-05-27,sex and the city 2,95000000,95347692,294680778,2010,199333086,sexandthecity220100527,sex and the city 22010
17,2010-02-12,percy jackson & the olympians: the lightning thief,95000000,88768303,223050874,2010,134282571,percyjacksontheolympiansthelightningthief20100212,percy jackson & the olympians: the lightning thief2010
18,2012-08-10,the campaign,95000000,86907746,104907746,2012,18000000,thecampaign20120810,the campaign2012
19,2010-11-12,unstoppable,95000000,81562942,165720921,2010,84157979,unstoppable20101112,unstoppable2010
21,2000-03-31,the road to el dorado,95000000,50802661,65700000,2000,14897339,theroadtoeldorado20000331,the road to el dorado2000
22,2009-12-11,the lovely bones,95000000,44114232,94894448,2009,50780216,thelovelybones20091211,the lovely bones2009
23,2016-08-19,ben-hur,95000000,26410477,91669648,2016,65259171,benhur20160819,ben-hur2016
24,2015-02-06,seventh son,95000000,17725785,108874967,2015,91149182,seventhson20150206,seventh son2015
25,2003-05-30,finding nemo,94000000,380529370,936429370,2003,555900000,findingnemo20030530,finding nemo2003
26,2003-12-17,the lord of the rings: the return of the king,94000000,377845905,1141403341,2003,763557436,thelordoftheringsthereturnoftheking20031217,the lord of the rings: the return of the king2003
27,2002-12-18,the lord of the rings: the two towers,94000000,342548984,934699645,2002,592150661,thelordoftheringsthetwotowers20021218,the lord of the rings: the two towers2002
28,2001-06-15,lara croft: tomb raider,94000000,131144183,273330185,2001,142186002,laracrofttombraider20010615,lara croft: tomb raider2001
29,2015-02-13,kingsman: the secret service,94000000,128261724,404561724,2015,276300000,kingsmanthesecretservice20150213,kingsman: the secret service2015
30,2001-07-18,jurassic park iii,93000000,181166115,365900000,2001,184733885,jurassicparkiii20010718,jurassic park iii2001
31,2011-08-05,rise of the planet of the apes,93000000,176760185,470986200,2011,294226015,riseoftheplanetoftheapes20110805,rise of the planet of the apes2011
32,2008-02-14,the spiderwick chronicles,92500000,71195053,162839667,2008,91644614,thespiderwickchronicles20080214,the spiderwick chronicles2008
33,2004-11-05,the incredibles,92000000,261441092,614726752,2004,353285660,theincredibles20041105,the incredibles2004
34,2013-02-14,a good day to die hard,92000000,67349198,304249198,2013,236900000,agooddaytodiehard20130214,a good day to die hard2013
35,2004-04-09,the alamo,92000000,22406362,23911362,2004,1505000,thealamo20040409,the alamo2004
37,2013-12-25,the secret life of walter mitty,91000000,58236838,187861183,2013,129624345,thesecretlifeofwaltermitty20131225,the secret life of walter mitty2013
38,2017-12-20,jumanji: welcome to the jungle,90000000,404508916,964496193,2017,559987277,jumanjiwelcometothejungle20171220,jumanji: welcome to the jungle2017
41,2001-08-03,rush hour 2,90000000,226164286,347425832,2001,121261546,rushhour220010803,rush hour 22001
42,2009-12-25,sherlock holmes,90000000,209028679,498438212,2009,289409533,sherlockholmes20091225,sherlock holmes2009
43,2009-07-01,ice age: dawn of the dinosaurs,90000000,196573705,859701857,2009,663128152,iceagedawnofthedinosaurs20090701,ice age: dawn of the dinosaurs2009
44,2018-12-14,spider-man: into the spider-verse 3d,90000000,190173195,375381768,2018,185208573,spidermanintothespiderverse3d20181214,spider-man: into the spider-verse 3d2018
45,2000-07-21,what lies beneath,90000000,155464351,288693989,2000,133229638,whatliesbeneath20000721,what lies beneath2000
46,2011-04-15,rio,90000000,143619809,487519809,2011,343900000,rio20110415,rio2011
47,2006-10-06,the departed,90000000,132384315,289660619,2006,157276304,thedeparted20061006,the departed2006
48,2000-11-03,charlie's angels,90000000,125305545,259736090,2000,134430545,charliesangels20001103,charlie's angels2000
50,2008-08-13,tropic thunder,90000000,110515313,191145256,2008,80629943,tropicthunder20080813,tropic thunder2008
51,2011-12-20,the girl with the dragon tattoo,90000000,102515793,239373970,2011,136858177,thegirlwiththedragontattoo20111220,the girl with the dragon tattoo2011
53,2008-06-06,you don't mess with the zohan,90000000,100018837,202910991,2008,102892154,youdontmesswiththezohan20080606,you don't mess with the zohan2008
55,2016-09-23,the magnificent seven,90000000,93432655,162525156,2016,69092501,themagnificentseven20160923,the magnificent seven2016
56,2015-12-18,alvin and the chipmunks: the road chip,90000000,85886987,249517956,2015,163630969,alvinandthechipmunkstheroadchip20151218,alvin and the chipmunks: the road chip2015
57,2001-06-08,atlantis: the lost empire,90000000,84052762,186049020,2001,101996258,atlantisthelostempire20010608,atlantis: the lost empire2001
58,2008-12-25,valkyrie,90000000,83107829,203932174,2008,120824345,valkyrie20081225,valkyrie2008
59,2015-07-24,pixels,90000000,78765986,244041804,2015,165275818,pixels20150724,pixels2015
60,2001-06-29,artificial intelligence: ai,90000000,78616689,235900000,2001,157283311,artificialintelligenceai20010629,artificial intelligence: ai2001
61,2003-11-26,the haunted mansion,90000000,75817994,155750628,2003,79932634,thehauntedmansion20031126,the haunted mansion2003
62,2000-08-04,hollow man,90000000,73209340,191200000,2000,117990660,hollowman20000804,hollow man2000
63,2005-04-22,the interpreter,90000000,72708161,162753837,2005,90045676,theinterpreter20050422,the interpreter2005
64,2013-08-07,percy jackson: sea of monsters,90000000,68559554,200859554,2013,132300000,percyjacksonseaofmonsters20130807,percy jackson: sea of monsters2013
65,2003-07-25,lara croft: tomb raider: the cradle of life,90000000,65653758,157092943,2003,91439185,laracrofttombraiderthecradleoflife20030725,lara croft: tomb raider: the cradle of life2003
66,2016-06-10,now you see me 2,90000000,65075540,328325007,2016,263249467,nowyouseeme220160610,now you see me 22016
67,2001-11-21,spy game,90000000,62362560,143049560,2001,80687000,spygame20011121,spy game2001
69,2000-03-10,mission to mars,90000000,60874615,106000000,2000,45125385,missiontomars20000310,mission to mars2000
70,2018-03-16,tomb raider,90000000,58250803,273477501,2018,215226698,tombraider20180316,tomb raider2018
72,2004-07-07,king arthur,90000000,51877963,203877963,2004,152000000,kingarthur20040707,king arthur2004
75,2002-07-19,k-19: the widowmaker,90000000,35168966,65716126,2002,30547160,k19thewidowmaker20020719,k-19: the widowmaker2002
76,2011-08-19,conan the barbarian,90000000,21295021,63356133,2011,42061112,conanthebarbarian20110819,conan the barbarian2011
77,2011-10-21,the three musketeers,90000000,20377913,139877913,2011,119500000,thethreemusketeers20111021,the three musketeers2011
78,2017-04-21,the promise,90000000,8224288,10551417,2017,2327129,thepromise20170421,the promise2017
79,2010-11-24,the nutcracker in 3d,90000000,195459,20466016,2010,20270557,thenutcrackerin3d20101124,the nutcracker in 3d2010
80,2017-12-13,bright,90000000,0,0,2017,0,bright20171213,bright2017
81,2019-12-31,army of the dead,90000000,0,0,2019,0,armyofthedead20191231,army of the dead2019
83,2005-06-03,cinderella man,88000000,61649911,105021488,2005,43371577,cinderellaman20050603,cinderella man2005
84,2018-09-14,the predator,88000000,51024708,159487563,2018,108462855,thepredator20180914,the predator2018
85,2005-07-08,fantastic four,87500000,154696080,333132750,2005,178436670,fantasticfour20050708,fantastic four2005
86,2001-02-09,hannibal,87000000,165092266,350100280,2001,185008014,hannibal20010209,hannibal2001
87,2003-07-25,seabiscuit,86000000,120277854,148715342,2003,28437488,seabiscuit20030725,seabiscuit2003
88,2000-12-22,cast away,85000000,233632142,427230516,2000,193598374,castaway20001222,cast away2000
89,2006-11-17,happy feet,85000000,198000317,385000317,2006,187000000,happyfeet20061117,happy feet2006
90,2001-12-07,ocean's eleven,85000000,183417150,450728529,2001,267311379,oceanseleven20011207,ocean's eleven2001
91,2004-07-23,the bourne supremacy,85000000,176087450,311001124,2004,134913674,thebournesupremacy20040723,the bourne supremacy2004
93,2009-04-03,fast & furious,85000000,155064265,363064265,2009,208000000,fastfurious20090403,fast & furious2009
94,2008-03-14,horton hears a who,85000000,154529439,299477886,2008,144948447,hortonhearsawho20080314,horton hears a who2008
95,2014-03-21,divergent,85000000,150947895,276014965,2014,125067070,divergent20140321,divergent2014
96,2012-09-28,hotel transylvania,85000000,148313048,378505812,2012,230192764,hoteltransylvania20120928,hotel transylvania2012
97,2019-04-05,shazam!,85000000,139606856,362899733,2019,223292877,shazam20190405,shazam!2019
98,2007-11-21,enchanted,85000000,127706877,340384141,2007,212677264,enchanted20071121,enchanted2007
99,2012-02-10,safe house,85000000,126181630,208542162,2012,82360532,safehouse20120210,safe house2012
100,2007-07-20,i now pronounce you chuck and larry,85000000,119725280,185708462,2007,65983182,inowpronounceyouchuckandlarry20070720,i now pronounce you chuck and larry2007
1,2007-06-08,ocean's thirteen,85000000,117144465,311744465,2007,194600000,oceansthirteen20070608,ocean's thirteen2007
2,2009-12-25,itâs complicated,85000000,112735375,224614744,2009,111879369,itâscomplicated20091225,itâs complicated2009
4,2006-09-29,open season,85000000,85105259,191932158,2006,106826899,openseason20060929,open season2006
5,2011-11-04,tower heist,85000000,78046570,150422946,2011,72376376,towerheist20111104,tower heist2011
6,2000-11-22,102 dalmatians,85000000,66941559,66941559,2000,0,102dalmatians20001122,102 dalmatians2000
7,2012-03-30,mirror mirror,85000000,64935167,173613482,2012,108678315,mirrormirror20120330,mirror mirror2012
8,2006-12-08,the holiday,85000000,63280000,205190324,2006,141910324,theholiday20061208,the holiday2006
9,2006-06-16,the fast and the furious: tokyo drift,85000000,62615510,157794205,2006,95178695,thefastandthefurioustokyodrift20060616,the fast and the furious: tokyo drift2006
10,2005-12-09,memoirs of a geisha,85000000,57010853,161510853,2005,104500000,memoirsofageisha20051209,memoirs of a geisha2005
11,2001-03-16,enemy at the gates,85000000,51396781,96971293,2001,45574512,enemyatthegates20010316,enemy at the gates2001
13,2003-09-26,the rundown,85000000,47641743,80831893,2003,33190150,therundown20030926,the rundown2003
14,2011-11-23,arthur christmas,85000000,46462469,149717124,2011,103254655,arthurchristmas20111123,arthur christmas2011
15,2017-01-20,xxx: return of xander cage,85000000,44898413,345033359,2017,300134946,xxxreturnofxandercage20170120,xxx: return of xander cage2017
17,2010-07-30,cats & dogs: the revenge of kitty galore,85000000,43585753,113026383,2010,69440630,catsdogstherevengeofkittygalore20100730,cats & dogs: the revenge of kitty galore2010
18,2002-02-08,collateral damage,85000000,40048332,78353508,2002,38305176,collateraldamage20020208,collateral damage2002
19,2002-03-15,showtime,85000000,37948765,78948765,2002,41000000,showtime20020315,showtime2002
21,2007-03-02,zodiac,85000000,33080084,83080084,2007,50000000,zodiac20070302,zodiac2007
22,2010-08-13,scott pilgrim vs. the world,85000000,31611316,48056764,2010,16445448,scottpilgrimvstheworld20100813,scott pilgrim vs. the world2010
23,2003-03-28,the core,85000000,31111260,74132631,2003,43021371,thecore20030328,the core2003
25,2017-12-20,the greatest showman,84000000,174340174,386665550,2017,212325376,thegreatestshowman20171220,the greatest showman2017
26,2002-06-14,scooby-doo,84000000,153294164,276294164,2002,123000000,scoobydoo20020614,scooby-doo2002
27,2000-07-28,nutty professor ii: the klumps,84000000,123307945,166307945,2000,43000000,nuttyprofessoriitheklumps20000728,nutty professor ii: the klumps2000
28,2013-07-19,red 2,84000000,53262560,141507355,2013,88244795,red220130719,red 22013
29,2006-06-23,click,82500000,137355633,237685089,2006,100329456,click20060623,click2006
30,2006-12-15,charlotte's web,82500000,82985708,143985708,2006,61000000,charlottesweb20061215,charlotte's web2006
31,2008-02-14,jumper,82500000,80172128,222640812,2008,142468684,jumper20080214,jumper2008
32,2008-07-11,hellboy ii: the golden army,82500000,75986503,160388063,2008,84401560,hellboyiithegoldenarmy20080711,hellboy ii: the golden army2008
33,2005-05-27,the longest yard,82000000,158119460,191558505,2005,33439045,thelongestyard20050527,the longest yard2005
34,2010-08-13,the expendables,82000000,103068524,268268174,2010,165199650,theexpendables20100813,the expendables2010
35,2000-11-17,the 6th day,82000000,34543701,96024898,2000,61481197,the6thday20001117,the 6th day2000
36,2020-02-21,call of the wild,82000000,0,0,2020,0,callofthewild20200221,call of the wild2020
37,2003-05-23,bruce almighty,81000000,242704995,484468608,2003,241763613,brucealmighty20030523,bruce almighty2003
38,2012-03-23,the hunger games,80000000,408010692,677923379,2012,269912687,thehungergames20120323,the hunger games2012
39,2011-05-26,the hangover part ii,80000000,254464305,586464305,2011,332000000,thehangoverpartii20110526,the hangover part ii2011
41,2017-02-10,the lego batman movie,80000000,175750384,310660018,2017,134909634,thelegobatmanmovie20170210,the lego batman movie2017
42,2015-09-25,hotel transylvania 2,80000000,169700110,469500298,2015,299800188,hoteltransylvania220150925,hotel transylvania 22015
45,2006-05-19,over the hedge,80000000,155019340,343397247,2006,188377907,overthehedge20060519,over the hedge2006
46,2002-06-21,lilo & stitch,80000000,145771527,245800000,2002,100028473,lilostitch20020621,lilo & stitch2002
48,2013-07-12,grown ups 2,80000000,133668525,247023808,2013,113355283,grownups220130712,grown ups 22013
49,2011-12-16,alvin and the chipmunks: chipwrecked,80000000,133107389,349088523,2011,215981134,alvinandthechipmunkschipwrecked20111216,alvin and the chipmunks: chipwrecked2011
50,2008-06-20,get smart,80000000,130319208,226739416,2008,96420208,getsmart20080620,get smart2008
51,2005-03-11,robots,80000000,128200012,260700012,2005,132500000,robots20050311,robots2005
52,2010-02-19,shutter island,80000000,128012934,299461782,2010,171448848,shutterisland20100219,shutter island2010
53,2003-12-12,something's gotta give,80000000,124685242,266685242,2003,142000000,somethingsgottagive20031212,something's gotta give2003
54,2008-11-26,four christmases,80000000,120146040,168311558,2008,48165518,fourchristmases20081126,four christmases2008
56,2008-12-25,bedtime stories,80000000,110101975,221468935,2008,111366960,bedtimestories20081225,bedtime stories2008
57,2002-07-12,road to perdition,80000000,104054514,183354514,2002,79300000,roadtoperdition20020712,road to perdition2002
58,2011-02-11,just go with it,80000000,103028109,214974953,2011,111946844,justgowithit20110211,just go with it2011
59,2003-02-14,daredevil,80000000,102543518,182782518,2003,80239000,daredevil20030214,daredevil2003
60,2008-09-26,eagle eye,80000000,101440743,180585259,2008,79144516,eagleeye20080926,eagle eye2008
62,2010-12-17,yogi bear,80000000,100246011,204774690,2010,104528679,yogibear20101217,yogi bear2010
63,2003-12-25,cold mountain,80000000,95632614,165173909,2003,69541295,coldmountain20031225,cold mountain2003
64,2010-01-15,the book of eli,80000000,94835059,158750817,2010,63915758,thebookofeli20100115,the book of eli2010
68,2014-10-17,fury,80000000,85817906,210315681,2014,124497775,fury20141017,fury2014
69,2018-09-28,smallfoot,80000000,83240103,213691277,2018,130451174,smallfoot20180928,smallfoot2018
70,2006-02-10,the pink panther,80000000,82226474,158926474,2006,76700000,thepinkpanther20060210,the pink panther2006
71,2011-07-08,zookeeper,80000000,80360866,170805525,2011,90444659,zookeeper20110708,zookeeper2011
72,2008-12-12,the day the earth stood still,80000000,79366978,237370350,2008,158003372,thedaytheearthstoodstill20081212,the day the earth stood still2008
75,2002-05-24,spirit: stallion of the cimarron,80000000,73215310,106515310,2002,33300000,spiritstallionofthecimarron20020524,spirit: stallion of the cimarron2002
76,2001-06-08,swordfish,80000000,69772969,147080413,2001,77307444,swordfish20010608,swordfish2001
79,2004-07-30,the manchurian candidate,80000000,65948711,96148711,2004,30200000,themanchuriancandidate20040730,the manchurian candidate2004
80,2006-11-22,dã©jã vu,80000000,64038616,181038616,2006,117000000,dãjãvu20061122,dã©jã vu2006
81,2019-06-07,the secret life of pets 2,80000000,63795655,113351496,2019,49555841,thesecretlifeofpets220190607,the secret life of pets 22019
82,2005-06-24,bewitched,80000000,63313159,131159306,2005,67846147,bewitched20050624,bewitched2005
83,2002-03-08,the time machine,80000000,56684819,98983590,2002,42298771,thetimemachine20020308,the time machine2002
86,2005-10-28,the legend of zorro,80000000,45575336,141475336,2005,95900000,thelegendofzorro20051028,the legend of zorro2005
87,2000-11-10,little nicky,80000000,39442871,58270391,2000,18827520,littlenicky20001110,little nicky2000
88,2009-09-25,surrogates,80000000,38577772,119668350,2009,81090578,surrogates20090925,surrogates2009
89,2001-06-08,evolution,80000000,38311134,98341932,2001,60030798,evolution20010608,evolution2001
90,2005-08-26,the brothers grimm,80000000,37899638,105299638,2005,67400000,thebrothersgrimm20050826,the brothers grimm2005
92,2006-04-14,the wild,80000000,37384046,99010667,2006,61626621,thewild20060414,the wild2006
93,2013-12-20,walking with dinosaurs,80000000,36076121,123368842,2013,87292721,walkingwithdinosaurs20131220,walking with dinosaurs2013
94,2000-12-22,thirteen days,80000000,34566746,66554547,2000,31987801,thirteendays20001222,thirteen days2000
96,2015-10-23,the last witch hunter,80000000,27367660,130818912,2015,103451252,thelastwitchhunter20151023,the last witch hunter2015
97,2014-02-21,pompeii,80000000,23169033,108469033,2014,85300000,pompeii20140221,pompeii2014
98,2000-05-12,battlefield earth: a saga of the year 3000,80000000,21471685,29725663,2000,8253978,battlefieldearthasagaoftheyear300020000512,battlefield earth: a saga of the year 30002000
99,2003-11-14,looney tunes: back in action,80000000,20950820,54540662,2003,33589842,looneytunesbackinaction20031114,looney tunes: back in action2003
100,2009-12-18,nine,80000000,19676965,53508858,2009,33831893,nine20091218,nine2009
1,2003-11-26,timeline,80000000,19480739,26703184,2003,7222445,timeline20031126,timeline2003
2,2010-04-22,oceans,80000000,19422319,86787530,2010,67365211,oceans20100422,oceans2010
5,2000-11-10,red planet,80000000,17480890,33463969,2000,15983079,redplanet20001110,red planet2000
6,2007-01-12,arthur et les minimoys,80000000,15132763,113325743,2007,98192980,arthuretlesminimoys20070112,arthur et les minimoys2007
7,2007-08-17,the invasion,80000000,15074191,40147042,2007,25072851,theinvasion20070817,the invasion2007
8,2005-09-02,a sound of thunder,80000000,1900451,6300451,2005,4400000,asoundofthunder20050902,a sound of thunder2005
10,2012-02-10,journey 2: the mysterious island,79000000,103860290,318146162,2012,214285872,journey2themysteriousisland20120210,journey 2: the mysterious island2012
11,2011-11-11,jack and jill,79000000,74158157,150519217,2011,76361060,jackandjill20111111,jack and jill2011
12,2001-12-21,a beautiful mind,78000000,170708996,317668058,2001,146959062,abeautifulmind20011221,a beautiful mind2001
13,2013-09-27,cloudy with a chance of meatballs 2,78000000,119793567,274392649,2013,154599082,cloudywithachanceofmeatballs220130927,cloudy with a chance of meatballs 22013
14,2002-10-04,red dragon,78000000,92955420,206455420,2002,113500000,reddragon20021004,red dragon2002
15,2004-03-05,hidalgo,78000000,67286731,108086731,2004,40800000,hidalgo20040305,hidalgo2004
16,2003-07-11,the league of extraordinary gentlemen,78000000,66465204,179265204,2003,112800000,theleagueofextraordinarygentlemen20030711,the league of extraordinary gentlemen2003
17,2004-08-20,exorcist: the beginning,78000000,41814863,43957541,2004,2142678,exorcistthebeginning20040820,exorcist: the beginning2004
18,2012-12-31,astã©rix et obã©lix: au service de sa majestã©,77600000,0,60680125,2012,60680125,astãrixetobãlixauservicedesamajestã20121231,astã©rix et obã©lix: au service de sa majestã©2012
19,2016-02-12,the little prince,77500000,1311213,102028919,2016,100717706,thelittleprince20160212,the little prince2016
20,2019-01-22,renegades,77500000,0,1521672,2019,1521672,renegades20190122,renegades2019
21,2018-07-20,the equalizer 2,77000000,102084362,190453132,2018,88368770,theequalizer220180720,the equalizer 22018
22,2013-07-03,despicable me 2,76000000,368065385,975216835,2013,607151450,despicableme220130703,despicable me 22013
23,2003-06-06,2 fast 2 furious,76000000,127120058,236410607,2003,109290549,2fast2furious20030606,2 fast 2 furious2003
24,2006-12-25,children of men,76000000,35552383,69845011,2006,34292628,childrenofmen20061225,children of men2006
25,2000-06-30,the adventures of rocky & bullwinkle,76000000,26000610,35129610,2000,9129000,theadventuresofrockybullwinkle20000630,the adventures of rocky & bullwinkle2000
26,2016-07-08,the secret life of pets,75000000,368384330,886750534,2016,518366204,thesecretlifeofpets20160708,the secret life of pets2016
28,2018-11-09,dr. seussâ the grinch,75000000,270620950,511002426,2018,240381476,drseussâthegrinch20181109,dr. seussâ the grinch2018
29,2016-12-21,sing,75000000,270329045,634454789,2016,364125744,sing20161221,sing2016
30,2017-06-30,despicable me 3,75000000,264624300,1034727750,2017,770103450,despicableme320170630,despicable me 32017
32,2006-03-31,ice age: the meltdown,75000000,195330621,651899282,2006,456568661,iceagethemeltdown20060331,ice age: the meltdown2006
33,2005-05-27,madagascar,75000000,193595521,556559566,2005,362964045,madagascar20050527,madagascar2005
34,2010-06-25,grown ups,75000000,162001186,272223430,2010,110222244,grownups20100625,grown ups2010
35,2004-10-01,shark tale,75000000,161412000,371917043,2004,210505043,sharktale20041001,shark tale2004
36,2000-07-14,x-men,75000000,157299717,296872367,2000,139572650,xmen20000714,x-men2000
37,2008-06-27,wanted,75000000,134508551,342416460,2008,207907909,wanted20080627,wanted2008
39,2004-02-13,50 first dates,75000000,120776832,196320329,2004,75543497,50firstdates20040213,50 first dates2004
40,2007-07-20,hairspray,75000000,118871849,203035572,2007,84163723,hairspray20070720,hairspray2007
41,2013-05-31,now you see me,75000000,117723989,342769200,2013,225045211,nowyouseeme20130531,now you see me2013
42,2006-12-15,dreamgirls,75000000,103365956,155708695,2006,52342739,dreamgirls20061215,dreamgirls2006
43,2018-08-03,christopher robin,75000000,99215042,197504758,2018,98289716,christopherrobin20180803,christopher robin2018
45,2011-11-11,immortals,75000000,83504017,211562435,2011,128058418,immortals20111111,immortals2011
46,2004-06-18,the terminal,75000000,77073959,218673959,2004,141600000,theterminal20040618,the terminal2004
47,2005-02-18,constantine,75000000,75976178,221594911,2005,145618733,constantine20050218,constantine2005
48,2006-07-21,monster house,75000000,73661010,141267370,2006,67606360,monsterhouse20060721,monster house2006
49,2000-12-08,vertical limit,75000000,68473360,213500000,2000,145026640,verticallimit20001208,vertical limit2000
50,2007-12-21,charlie wilson's war,75000000,66661095,119512771,2007,52851676,charliewilsonswar20071221,charlie wilson's war2007
52,2005-03-04,be cool,75000000,55849401,94944017,2005,39094616,becool20050304,be cool2005
53,2005-12-23,munich,75000000,47379090,131492772,2005,84113682,munich20051223,munich2005
54,2010-06-04,killers,75000000,47059963,95572749,2010,48512786,killers20100604,killers2010
55,2015-08-14,the man from u.n.c.l.e.,75000000,45445109,104949584,2015,59504475,themanfromuncle20150814,the man from u.n.c.l.e.2015
56,2003-03-07,tears of the sun,75000000,43632458,85632458,2003,42000000,tearsofthesun20030307,tears of the sun2003
57,2006-07-21,lady in the water,75000000,42285169,72785169,2006,30500000,ladyinthewater20060721,lady in the water2006
58,2004-12-17,spanglish,75000000,42044321,54344321,2004,12300000,spanglish20041217,spanglish2004
59,2001-10-12,bandits,75000000,41523271,71523271,2001,30000000,bandits20011012,bandits2001
62,2011-03-25,sucker punch,75000000,36392502,89758389,2011,53365887,suckerpunch20110325,sucker punch2011
63,2005-03-11,hostage,75000000,34636443,77636443,2005,43000000,hostage20050311,hostage2005
64,2016-10-28,inferno,75000000,34343574,219519367,2016,185175793,inferno20161028,inferno2016
65,2003-06-13,hollywood homicide,75000000,30207785,50409753,2003,20201968,hollywoodhomicide20030613,hollywood homicide2003
66,2000-06-16,titan a.e.,75000000,22751979,36751979,2000,14000000,titanae20000616,titan a.e.2000
67,2004-12-17,flight of the phoenix,75000000,21009180,34009180,2004,13000000,flightofthephoenix20041217,flight of the phoenix2004
70,2001-02-23,monkeybone,75000000,5409517,5409517,2001,0,monkeybone20010223,monkeybone2001
71,2019-08-30,playmobil,75000000,0,0,2019,0,playmobil20190830,playmobil2019
72,2019-12-31,355,75000000,0,0,2019,0,35520191231,3552019
73,2015-07-10,minions,74000000,336045770,1160336173,2015,824290403,minions20150710,minions2015
74,2015-02-06,the spongebob movie: sponge out of water,74000000,162994032,311013181,2015,148019149,thespongebobmoviespongeoutofwater20150206,the spongebob movie: sponge out of water2015
75,2000-11-22,unbreakable,73243106,94999143,248099143,2000,153100000,unbreakable20001122,unbreakable2000
76,2006-08-04,talladega nights: the ballad of ricky bobby,73000000,148213377,162870525,2006,14657148,talladeganightstheballadofrickybobby20060804,talladega nights: the ballad of ricky bobby2006
77,2016-05-20,the angry birds movie,73000000,107509366,352327887,2016,244818521,theangrybirdsmovie20160520,the angry birds movie2016
80,2007-07-27,the simpsons movie,72500000,183135014,527071022,2007,343936008,thesimpsonsmovie20070727,the simpsons movie2007
81,2008-02-08,fool's gold,72500000,70231041,109362966,2008,39131925,foolsgold20080208,fool's gold2008
82,2009-07-31,funny people,72500000,51855045,71880305,2009,20025260,funnypeople20090731,funny people2009
83,2007-09-28,the kingdom,72500000,47467250,86509602,2007,39042352,thekingdom20070928,the kingdom2007
84,2001-06-22,dr. dolittle 2,72000000,112950721,176101721,2001,63151000,drdolittle220010622,dr. dolittle 22001
86,2005-11-04,jarhead,72000000,62647540,96947540,2005,34300000,jarhead20051104,jarhead2005
87,2001-04-27,driven,72000000,32616869,54616869,2001,22000000,driven20010427,driven2001
88,2001-12-21,the majestic,72000000,27796042,37306334,2001,9510292,themajestic20011221,the majestic2001
89,2004-06-25,two brothers,72000000,19176754,62176754,2004,43000000,twobrothers20040625,two brothers2004
90,2004-07-30,the village,71682975,114197520,257641634,2004,143444114,thevillage20040730,the village2004
92,2002-08-02,signs,70702619,227969295,408269295,2002,180300000,signs20020802,signs2002
93,2004-05-19,shrek 2,70000000,441226247,937008132,2004,495781885,shrek220040519,shrek 22004
94,2006-06-09,cars,70000000,244082982,461651246,2006,217568264,cars20060609,cars2006
95,2009-12-23,alvin and the chipmunks: the squeakquel,70000000,219614612,443483213,2009,223868601,alvinandthechipmunksthesqueakquel20091223,alvin and the chipmunks: the squeakquel2009
98,2002-08-09,xxx,70000000,141930000,267200000,2002,125270000,xxx20020809,xxx2002
99,2018-06-08,oceanâs 8,70000000,140218711,297115976,2018,156897265,oceanâs820180608,oceanâs 82018
1,2009-08-21,inglourious basterds,70000000,120774594,316915264,2009,196140670,inglouriousbasterds20090821,inglourious basterds2009
4,2003-08-08,s.w.a.t.,70000000,116877597,207154748,2003,90277151,swat20030808,s.w.a.t.2003
5,2017-11-10,daddyâs home 2,70000000,104029443,175807183,2017,71777740,daddyâshome220171110,daddyâs home 22017
7,2001-12-14,vanilla sky,70000000,100614858,202726605,2001,102111747,vanillasky20011214,vanilla sky2001
9,2013-03-22,olympus has fallen,70000000,98927592,172878928,2013,73951336,olympushasfallen20130322,olympus has fallen2013
10,2011-03-11,battle: los angeles,70000000,83552429,213463976,2011,129911547,battlelosangeles20110311,battle: los angeles2011
11,2004-08-13,avp: alien vs. predator,70000000,80281096,172543519,2004,92262423,avpalienvspredator20040813,avp: alien vs. predator2004
12,2011-12-25,war horse,70000000,79883359,156815529,2011,76932170,warhorse20111225,war horse2011
13,2002-03-01,we were soldiers,70000000,78120196,114658262,2002,36538066,weweresoldiers20020301,we were soldiers2002
14,2014-02-07,the monuments men,70000000,78031620,158702748,2014,80671128,themonumentsmen20140207,the monuments men2014
15,2016-09-23,storks,70000000,72679278,183353431,2016,110674153,storks20160923,storks2016
17,2003-12-10,big fish,70000000,66432867,123954323,2003,57521456,bigfish20031210,big fish2003
19,2012-01-20,underworld: awakening,70000000,62321039,160379930,2012,98058891,underworldawakening20120120,underworld: awakening2012
20,2017-09-22,the lego ninjago movie,70000000,59281555,122737201,2017,63455646,thelegoninjagomovie20170922,the lego ninjago movie2017
21,2014-10-10,dracula untold,70000000,55991880,220241723,2014,164249843,draculauntold20141010,dracula untold2014
22,2006-09-29,the guardian,70000000,55011732,94973540,2006,39961808,theguardian20060929,the guardian2006
24,2010-09-24,wall street 2: money never sleeps,70000000,52474616,137431619,2010,84957003,wallstreet2moneyneversleeps20100924,wall street 2: money never sleeps2010
25,2011-01-14,the dilemma,70000000,48475290,70546865,2011,22071575,thedilemma20110114,the dilemma2011
26,2005-12-25,rumor has it,70000000,42996140,88933562,2005,45937422,rumorhasit20051225,rumor has it2005
28,2007-08-10,stardust,70000000,38634938,137022245,2007,98387307,stardust20070810,stardust2007
29,2012-06-15,rock of ages,70000000,38518613,61031932,2012,22513319,rockofages20120615,rock of ages2012
31,2004-09-17,sky captain and the world of tomorrow,70000000,37760080,49730854,2004,11970774,skycaptainandtheworldoftomorrow20040917,sky captain and the world of tomorrow2004
32,2007-09-14,the brave one,70000000,36793804,69792704,2007,32998900,thebraveone20070914,the brave one2007
33,2002-11-01,i spy,70000000,33561137,60279822,2002,26718685,ispy20021101,i spy2002
34,2002-06-07,bad company,70000000,30157016,69157016,2002,39000000,badcompany20020607,bad company2002
35,2005-10-21,doom,70000000,28212337,58757178,2005,30544841,doom20051021,doom2005
36,2016-01-29,the finest hours,70000000,27569558,49252761,2016,21683203,thefinesthours20160129,the finest hours2016
37,2013-10-18,escape plan,70000000,25135965,103735965,2013,78600000,escapeplan20131018,escape plan2013
38,2011-09-23,killer elite,70000000,25124986,65409046,2011,40284060,killerelite20110923,killer elite2011
40,2002-02-15,hart's war,70000000,19076815,33076815,2002,14000000,hartswar20020215,hart's war2002
41,2002-02-08,rollerball,70000000,18990542,25852508,2002,6861966,rollerball20020208,rollerball2002
42,2014-01-10,the legend of hercules,70000000,18848538,58953319,2014,40104781,thelegendofhercules20140110,the legend of hercules2014
43,2007-04-27,next,70000000,18211013,73591500,2007,55380487,next20070427,next2007
44,2002-09-20,ballistic: ecks vs. sever,70000000,14294842,14294842,2002,0,ballisticecksvssever20020920,ballistic: ecks vs. sever2002
45,2001-08-10,osmosis jones,70000000,13596911,13596911,2001,0,osmosisjones20010810,osmosis jones2001
46,2014-05-09,legends of oz: dorothyâs return,70000000,8462347,20107933,2014,11645586,legendsofozdorothyâsreturn20140509,legends of oz: dorothyâs return2014
47,2015-01-16,blackhat,70000000,8005980,19665004,2015,11659024,blackhat20150116,blackhat2015
48,2006-03-31,basic instinct 2,70000000,5946136,35417162,2006,29471026,basicinstinct220060331,basic instinct 22006
49,2010-05-28,agora,70000000,619423,38992292,2010,38372869,agora20100528,agora2010
50,2010-07-09,despicable me,69000000,251513985,543464573,2010,291950588,despicableme20100709,despicable me2010
51,2010-07-30,dinner for schmucks,69000000,73026337,86796502,2010,13770165,dinnerforschmucks20100730,dinner for schmucks2010
52,2018-03-02,red sparrow,69000000,46874505,145951861,2018,99077356,redsparrow20180302,red sparrow2018
53,2010-06-30,the twilight saga: eclipse,68000000,300531751,706102828,2010,405571077,thetwilightsagaeclipse20100630,the twilight saga: eclipse2010
54,2002-05-31,the sum of all fears,68000000,118471320,193500000,2002,75028680,thesumofallfears20020531,the sum of all fears2002
55,2015-06-26,ted 2,68000000,81476385,217214143,2015,135737758,ted220150626,ted 22015
56,2001-07-13,the score,68000000,71069884,113542091,2001,42472207,thescore20010713,the score2001
57,2011-02-25,hall pass,68000000,45060734,87173475,2011,42112741,hallpass20110225,hall pass2011
59,2003-03-21,dreamcatcher,68000000,33685268,75685268,2003,42000000,dreamcatcher20030321,dreamcatcher2003
62,2017-12-22,downsizing,68000000,24449754,54462971,2017,30013217,downsizing20171222,downsizing2017
63,2012-03-02,doctor seuss' the lorax,67500000,214030500,350976753,2012,136946253,doctorseussthelorax20120302,doctor seuss' the lorax2012
64,2008-10-10,body of lies,67500000,39394666,118556530,2008,79161864,bodyoflies20081010,body of lies2008
65,2012-06-22,abraham lincoln: vampire hunter,67500000,37519139,137489730,2012,99970591,abrahamlincolnvampirehunter20120622,abraham lincoln: vampire hunter2012
67,2007-08-17,the last legion,67000000,5932060,25357771,2007,19425711,thelastlegion20070817,the last legion2007
70,2014-03-14,need for speed,66000000,43568507,194169619,2014,150601112,needforspeed20140314,need for speed2014
72,2000-12-15,what women want,65000000,182805123,374105123,2000,191300000,whatwomenwant20001215,what women want2000
73,2012-11-09,lincoln,65000000,182207973,273346281,2012,91138308,lincoln20121109,lincoln2012
74,2002-03-15,ice age,65000000,176387405,386116343,2002,209728938,iceage20020315,ice age2002
77,2018-07-13,hotel transylvania 3: summer vacation,65000000,167500092,527079962,2018,359579870,hoteltransylvania3summervacation20180713,hotel transylvania 3: summer vacation2018
78,2012-12-25,les miserables,65000000,148809770,442169052,2012,293359282,lesmiserables20121225,les miserables2012
79,2002-11-01,the santa clause 2,65000000,139225854,172825854,2002,33600000,thesantaclause220021101,the santa clause 22002
82,2014-12-25,unbroken,65000000,115637895,163527824,2014,47889929,unbroken20141225,unbroken2014
83,2015-06-05,spy!,65000000,110825712,232585748,2015,121760036,spy20150605,spy!2015
84,2010-11-05,due date,65000000,100539043,211739043,2010,111200000,duedate20101105,due date2010
85,2008-07-25,step brothers,65000000,100468793,128468793,2008,28000000,stepbrothers20080725,step brothers2008
88,2000-08-04,space cowboys,65000000,90454043,128874043,2000,38420000,spacecowboys20000804,space cowboys2000
89,2014-12-19,annie,65000000,85911262,139829625,2014,53918363,annie20141219,annie2014
91,2016-08-12,peteâs dragon,65000000,76233151,137768975,2016,61535824,peteâsdragon20160812,peteâs dragon2016
93,2006-08-09,world trade center,65000000,70278893,163295654,2006,93016761,worldtradecenter20060809,world trade center2006
94,2000-07-07,the kid,65000000,69688384,69688384,2000,0,thekid20000707,the kid2000
95,2003-12-19,mona lisa smile,65000000,63803100,141205169,2003,77402069,monalisasmile20031219,mona lisa smile2003
96,2012-05-16,the dictator,65000000,59650222,180148897,2012,120498675,thedictator20120516,the dictator2012
98,2012-02-17,this means war,65000000,54760791,156974557,2012,102213766,thismeanswar20120217,this means war2012
99,2015-02-27,focus,65000000,53862963,168065700,2015,114202737,focus20150227,focus2015
100,2004-12-08,blade: trinity,65000000,52397389,131353165,2004,78955776,bladetrinity20041208,blade: trinity2004
1,2012-11-21,red dawn,65000000,44806783,48164150,2012,3357367,reddawn20121121,red dawn2012
2,2006-12-22,we are marshall,65000000,43545364,43545364,2006,0,wearemarshall20061222,we are marshall2006
3,2015-09-18,everest,65000000,43482270,221297061,2015,177814791,everest20150918,everest2015
4,2012-09-14,resident evil: retribution,65000000,42345531,240647629,2012,198302098,residentevilretribution20120914,resident evil: retribution2012
7,2008-08-22,death race,65000000,36316032,72516819,2008,36200787,deathrace20080822,death race2008
9,2000-12-08,proof of life,65000000,32598931,62761005,2000,30162074,proofoflife20001208,proof of life2000
10,2005-11-11,zathura,65000000,28045540,58545540,2005,30500000,zathura20051111,zathura2005
11,2003-11-26,the missing,65000000,26900336,38253433,2003,11353097,themissing20031126,the missing2003
12,2005-01-14,elektra,65000000,24409722,56824633,2005,32414911,elektra20050114,elektra2005
13,2009-10-23,astro boy,65000000,19551067,41636243,2009,22085176,astroboy20091023,astro boy2009
14,2014-01-24,"i, frankenstein",65000000,19075290,74575290,2014,55500000,ifrankenstein20140124,"i, frankenstein2014"
16,2014-08-22,sin city: a dame to kill for,65000000,13757804,40650842,2014,26893038,sincityadametokillfor20140822,sin city: a dame to kill for2014
17,2016-12-25,live by night,65000000,10378555,21774432,2016,11395877,livebynight20161225,live by night2016
18,2000-10-27,lucky numbers,65000000,10014234,10014234,2000,0,luckynumbers20001027,lucky numbers2000
19,2005-09-23,oliver twist,65000000,2070920,26670920,2005,24600000,olivertwist20050923,oliver twist2005
20,2015-09-04,tian jiang xiong shi,65000000,74070,122519874,2015,122445804,tianjiangxiongshi20150904,tian jiang xiong shi2015
21,2018-10-26,air strike,65000000,0,516279,2018,516279,airstrike20181026,air strike2018
22,2006-07-14,little man,64000000,58636047,101636047,2006,43000000,littleman20060714,little man2006
24,2006-12-27,perfume: the story of a murderer,63700000,2223293,133603463,2006,131380170,perfumethestoryofamurderer20061227,perfume: the story of a murderer2006
26,2002-07-25,austin powers in goldmember,63000000,213117789,296338663,2002,83220874,austinpowersingoldmember20020725,austin powers in goldmember2002
27,2011-04-01,hop,63000000,108085305,188657593,2011,80572288,hop20110401,hop2011
28,2017-09-15,american assassin,63000000,36249674,68310140,2017,32060466,americanassassin20170915,american assassin2017
31,2000-04-21,u-571,62000000,77086030,127630030,2000,50544000,u57120000421,u-5712000
33,2015-12-25,the hateful eight,62000000,54117416,147864886,2015,93747470,thehatefuleight20151225,the hateful eight2015
34,2008-06-20,the love guru,62000000,32235793,40159017,2008,7923224,theloveguru20080620,the love guru2008
35,2001-02-23,3000 miles to graceland,62000000,15738632,18708848,2001,2970216,3000milestograceland20010223,3000 miles to graceland2001
36,2014-10-03,gone girl,61000000,167767189,368567189,2014,200800000,gonegirl20141003,gone girl2014
37,2007-03-30,blades of glory,61000000,118594548,145594548,2007,27000000,bladesofglory20070330,blades of glory2007
38,2015-09-18,maze runner: the scorch trials,61000000,81697192,310566162,2015,228868970,mazerunnerthescorchtrials20150918,maze runner: the scorch trials2015
39,2013-08-02,2 guns,61000000,75612460,132493015,2013,56880555,2guns20130802,2 guns2013
40,2018-01-26,maze runner: the death cure,61000000,58032443,265878536,2018,207846093,mazerunnerthedeathcure20180126,maze runner: the death cure2018
41,2019-01-11,a dogâs way home,61000000,41952715,81149689,2019,39196974,adogâswayhome20190111,a dogâs way home2019
42,2016-02-19,mei ren yu,60720000,3229457,554516671,2016,551287214,meirenyu20160219,mei ren yu2016
43,2004-12-22,meet the fockers,60000000,279167575,516567575,2004,237400000,meetthefockers20041222,meet the fockers2004
44,2014-02-07,the lego movie,60000000,257784718,457729388,2014,199944670,thelegomovie20140207,the lego movie2014
45,2007-03-09,300,60000000,210614939,454161935,2007,243546996,30020070309,3002007
46,2007-03-02,wild hogs,60000000,168213584,253555383,2007,85341799,wildhogs20070302,wild hogs2007
47,2008-12-25,marley & me,60000000,143153751,247812011,2008,104658260,marleyme20081225,marley & me2008
50,2016-09-09,sully,60000000,125070033,238524556,2016,113454523,sully20160909,sully2016
51,2002-06-14,the bourne identity,60000000,121468960,214357371,2002,92888411,thebourneidentity20020614,the bourne identity2002
52,2009-10-09,couples retreat,60000000,109205660,172450423,2009,63244763,couplesretreat20091009,couples retreat2009
54,2003-05-30,the italian job,60000000,106126012,176262839,2003,70136827,theitalianjob20030530,the italian job2003
55,2003-05-09,daddy day care,60000000,104148781,164285587,2003,60136806,daddydaycare20030509,daddy day care2003
58,2004-08-06,collateral,60000000,100170152,217670152,2004,117500000,collateral20040806,collateral2004
59,2001-07-04,cats & dogs,60000000,93375151,200700000,2001,107324849,catsdogs20010704,cats & dogs2001
60,2002-12-20,two weeks notice,60000000,93354918,199043309,2002,105688391,twoweeksnotice20021220,two weeks notice2002
62,2002-04-19,the scorpion king,60000000,90580000,165890634,2002,75310634,thescorpionking20020419,the scorpion king2002
63,2010-10-15,red,60000000,90380162,196439693,2010,106059531,red20101015,red2010
64,2004-03-05,starsky & hutch,60000000,88200225,170200225,2004,82000000,starskyhutch20040305,starsky & hutch2004
66,2005-12-21,cheaper by the dozen 2,60000000,82571173,135015330,2005,52444157,cheaperbythedozen220051221,cheaper by the dozen 22005
67,2010-08-13,eat pray love,60000000,80574010,206598789,2010,126024779,eatpraylove20100813,eat pray love2010
68,2012-12-21,jack reacher,60000000,80070736,217370736,2012,137300000,jackreacher20121221,jack reacher2012
69,2004-04-23,man on fire,60000000,77906816,130968579,2004,53061763,manonfire20040423,man on fire2004
70,2000-12-22,the family man,60000000,75764085,124715863,2000,48951778,thefamilyman20001222,the family man2000
71,2011-09-09,contagion,60000000,75658097,137551594,2011,61893497,contagion20110909,contagion2011
74,2009-02-06,coraline,60000000,75286229,126037057,2009,50750828,coraline20090206,coraline2009
75,2004-10-01,ladder 49,60000000,74541707,102332848,2004,27791141,ladder4920041001,ladder 492004
77,2009-10-28,michael jackson's this is it,60000000,72091016,252091016,2009,180000000,michaeljacksonsthisisit20091028,michael jackson's this is it2009
78,2003-01-17,kangaroo jack,60000000,66723216,90723216,2003,24000000,kangaroojack20030117,kangaroo jack2003
79,2008-06-13,the happening,60000000,64506874,162778384,2008,98271510,thehappening20080613,the happening2008
80,2016-03-04,london has fallen,60000000,62524260,195194085,2016,132669825,londonhasfallen20160304,london has fallen2016
81,2000-04-07,rules of engagement,60000000,61322858,71719931,2000,10397073,rulesofengagement20000407,rules of engagement2000
82,2006-03-10,the shaggy dog,60000000,61123569,87123569,2006,26000000,theshaggydog20060310,the shaggy dog2006
84,2004-04-02,hellboy,60000000,59623958,99823958,2004,40200000,hellboy20040402,hellboy2004
85,2016-10-21,jack reacher: never go back,60000000,58697076,159946489,2016,101249413,jackreachernevergoback20161021,jack reacher: never go back2016
86,2017-05-25,baywatch,60000000,58060186,175863783,2017,117803597,baywatch20170525,baywatch2017
88,2015-12-25,joy,60000000,56451232,101134059,2015,44682827,joy20151225,joy2015
89,2012-08-17,paranorman,60000000,56003051,108119662,2012,52116611,paranorman20120817,paranorman2012
91,2003-12-25,paycheck,60000000,53789313,98819789,2003,45030476,paycheck20031225,paycheck2003
93,2008-12-19,the tale of despereaux,60000000,50877145,90482317,2008,39605172,thetaleofdespereaux20081219,the tale of despereaux2008
94,2014-09-26,the boxtrolls,60000000,50837305,111946251,2014,61108946,theboxtrolls20140926,the boxtrolls2014
95,2017-08-04,the dark tower,60000000,50701325,113461527,2017,62760202,thedarktower20170804,the dark tower2017
96,2002-09-27,the tuxedo,60000000,50586000,104429625,2002,53843625,thetuxedo20020927,the tuxedo2002
97,2014-01-17,jack ryan: shadow recruit,60000000,50577412,131377412,2014,80800000,jackryanshadowrecruit20140117,jack ryan: shadow recruit2014
99,2005-03-24,miss congeniality 2: armed and fabulous,60000000,48478006,101382396,2005,52904390,misscongeniality2armedandfabulous20050324,miss congeniality 2: armed and fabulous2005
100,2018-12-25,vice,60000000,47836282,70883171,2018,23046889,vice20181225,vice2018
2,2007-03-23,shooter,60000000,47003582,95538560,2007,48534978,shooter20070323,shooter2007
4,2013-01-11,gangster squad,60000000,46000903,104100903,2013,58100000,gangstersquad20130111,gangster squad2013
5,2017-04-07,smurfs: the lost village,60000000,45020282,197578586,2017,152558304,smurfsthelostvillage20170407,smurfs: the lost village2017
6,2018-10-12,first man,60000000,44936545,105203825,2018,60267280,firstman20181012,first man2018
7,2009-06-19,year one,60000000,43337279,57604723,2009,14267444,yearone20090619,year one2009
8,2010-01-29,edge of darkness,60000000,43313890,82812456,2010,39498566,edgeofdarkness20100129,edge of darkness2010
9,2002-12-13,star trek: nemesis,60000000,43254409,67312826,2002,24058417,startreknemesis20021213,star trek: nemesis2002
10,2002-02-19,reign of fire,60000000,43061982,82150183,2002,39088201,reignoffire20020219,reign of fire2002
11,2009-11-20,planet 51,60000000,42194060,108996113,2009,66802053,planet5120091120,planet 512009
12,2009-03-20,duplicity,60000000,40572825,81079566,2009,40506741,duplicity20090320,duplicity2009
13,2008-09-12,righteous kill,60000000,40081410,78481410,2008,38400000,righteouskill20080912,righteous kill2008
14,2009-12-11,invictus,60000000,37491364,124514011,2009,87022647,invictus20091211,invictus2009
15,2009-04-17,state of play,60000000,37017955,88832210,2009,51814255,stateofplay20090417,state of play2009
17,2006-04-21,the sentinel,60000000,36280697,78080697,2006,41800000,thesentinel20060421,the sentinel2006
18,2012-09-21,trouble with the curve,60000000,35763137,47818913,2012,12055776,troublewiththecurve20120921,trouble with the curve2012
19,2003-10-10,intolerable cruelty,60000000,35327628,121327628,2003,86000000,intolerablecruelty20031010,intolerable cruelty2003
22,2000-09-15,almost famous,60000000,32522352,47371191,2000,14848839,almostfamous20000915,almost famous2000
23,2019-02-08,cold pursuit,60000000,32138862,62599159,2019,30460297,coldpursuit20190208,cold pursuit2019
24,2002-12-06,analyze that,60000000,32122249,54994757,2002,22872508,analyzethat20021206,analyze that2002
25,2009-04-24,the soloist,60000000,31853584,38522450,2009,6668866,thesoloist20090424,the soloist2009
26,2013-08-21,the mortal instruments: city of bones,60000000,31165421,75965567,2013,44800146,themortalinstrumentscityofbones20130821,the mortal instruments: city of bones2013
27,2000-11-03,the legend of bagger vance,60000000,30695227,39235486,2000,8540259,thelegendofbaggervance20001103,the legend of bagger vance2000
28,2002-02-22,dragonfly,60000000,30063805,30063805,2002,0,dragonfly20020222,dragonfly2002
29,2011-05-13,priest,60000000,29136626,84154026,2011,55017400,priest20110513,priest2011
30,2006-06-16,garfield: a tail of two kitties,60000000,28426747,147985373,2006,119558626,garfieldatailoftwokitties20060616,garfield: a tail of two kitties2006
31,2005-04-29,xxx: state of the union,60000000,26873932,71073932,2005,44200000,xxxstateoftheunion20050429,xxx: state of the union2005
33,2003-07-02,sinbad: legend of the seven seas,60000000,26483452,80767884,2003,54284432,sinbadlegendofthesevenseas20030702,sinbad: legend of the seven seas2003
34,2005-07-08,dark water,60000000,25473093,49473093,2005,24000000,darkwater20050708,dark water2005
36,2006-09-15,the black dahlia,60000000,22672813,49238525,2006,26565712,theblackdahlia20060915,the black dahlia2006
38,2008-12-25,the spirit,60000000,19806188,39006188,2008,19200000,thespirit20081225,the spirit2008
39,2001-10-19,the last castle,60000000,18208078,20541668,2001,2333590,thelastcastle20011019,the last castle2001
40,2009-01-23,inkheart,60000000,17303424,66655938,2009,49352514,inkheart20090123,inkheart2009
41,2000-01-14,supernova,60000000,14218868,14816494,2000,597626,supernova20000114,supernova2000
42,2006-09-22,flyboys,60000000,13090630,14816379,2006,1725749,flyboys20060922,flyboys2006
43,2014-02-14,winterâs tale,60000000,12600231,29575033,2014,16974802,winterâstale20140214,winterâs tale2014
45,2008-07-11,meet dave,60000000,11803254,50648806,2008,38845552,meetdave20080711,meet dave2008
46,2005-08-12,the great raid,60000000,10166502,10597070,2005,430568,thegreatraid20050812,the great raid2005
47,2017-02-24,rock dog,60000000,9420546,24148488,2017,14727942,rockdog20170224,rock dog2017
48,2015-01-23,mortdecai,60000000,7696134,30396134,2015,22700000,mortdecai20150123,mortdecai2015
49,2008-01-11,in the name of the king: a dungeon siege tale,60000000,4775656,13233220,2008,8457564,inthenameofthekingadungeonsiegetale20080111,in the name of the king: a dungeon siege tale2008
50,2003-10-24,beyond borders,60000000,4426297,11427090,2003,7000793,beyondborders20031024,beyond borders2003
51,2016-02-05,xi you ji zhi sun wu kong san da bai gu jing,60000000,709982,194058503,2016,193348521,xiyoujizhisunwukongsandabaigujing20160205,xi you ji zhi sun wu kong san da bai gu jing2016
52,2015-12-11,the ridiculous 6,60000000,0,0,2015,0,theridiculous620151211,the ridiculous 62015
53,2019-11-08,midway,59500000,0,0,2019,0,midway20191108,midway2019
54,2018-03-23,sherlock gnomes,59000000,43242871,87527651,2018,44284780,sherlockgnomes20180323,sherlock gnomes2018
55,2019-01-25,the kid who would be king,59000000,16790790,28348446,2019,11557656,thekidwhowouldbeking20190125,the kid who would be king2019
56,2016-02-12,deadpool,58000000,363070709,801025593,2016,437954884,deadpool20160212,deadpool2016
57,2014-12-25,american sniper,58000000,350126372,547326372,2014,197200000,americansniper20141225,american sniper2014
58,2015-10-16,goosebumps,58000000,80069458,158905324,2015,78835866,goosebumps20151016,goosebumps2015
61,2012-01-20,red tails,58000000,49876377,50365498,2012,489121,redtails20120120,red tails2012
62,2005-09-16,just like heaven,58000000,48318130,100687083,2005,52368953,justlikeheaven20050916,just like heaven2005
63,2013-06-07,the internship,58000000,44672764,93672764,2013,49000000,theinternship20130607,the internship2013
64,2000-04-28,the flintstones in viva rock vegas,58000000,35231365,59431365,2000,24200000,theflintstonesinvivarockvegas20000428,the flintstones in viva rock vegas2000
65,2008-04-04,leatherheads,58000000,31373938,41348628,2008,9974690,leatherheads20080404,leatherheads2008
66,2017-03-24,life,58000000,30234022,100929666,2017,70695644,life20170324,life2017
67,2009-12-18,did you hear about the morgans?,58000000,29580087,80480566,2009,50900479,didyouhearaboutthemorgans20091218,did you hear about the morgans?2009
68,2008-12-12,"che, part 1: the argentine",58000000,1802521,31627370,2008,29824849,chepart1theargentine20081212,"che, part 1: the argentine2008"
69,2008-05-30,sex and the city,57500000,152647258,415247258,2008,262600000,sexandthecity20080530,sex and the city2008
70,2010-09-10,resident evil: afterlife,57500000,60128566,295874190,2010,235745624,residentevilafterlife20100910,resident evil: afterlife2010
71,2012-06-15,that's my boy,57500000,36931089,58085235,2012,21154146,thatsmyboy20120615,that's my boy2012
73,2012-02-17,ghost rider: spirit of vengeance,57000000,51774002,149217355,2012,97443353,ghostriderspiritofvengeance20120217,ghost rider: spirit of vengeance2012
75,2004-11-12,after the sunset,57000000,28328132,38329114,2004,10000982,afterthesunset20041112,after the sunset2004
76,2001-08-17,captain corelli's mandolin,57000000,25528495,62097495,2001,36569000,captaincorellismandolin20010817,captain corelli's mandolin2001
77,2014-12-25,into the woods,56200000,128002372,213116401,2014,85114029,intothewoods20141225,into the woods2014
78,2003-04-11,anger management,56000000,135560942,195660942,2003,60100000,angermanagement20030411,anger management2003
79,2005-03-04,the pacifier,56000000,113006880,198006880,2005,85000000,thepacifier20050304,the pacifier2005
80,2004-04-02,walking tall,56000000,46213824,47313824,2004,1100000,walkingtall20040402,walking tall2004
81,2016-01-22,zhuo yao ji,56000000,32766,359495591,2016,359462825,zhuoyaoji20160122,zhuo yao ji2016
83,2007-12-14,alvin and the chipmunks,55000000,217326974,362605033,2007,145278059,alvinandthechipmunks20071214,alvin and the chipmunks2007
84,2018-11-02,bohemian rhapsody,55000000,216303339,894985342,2018,678682003,bohemianrhapsody20181102,bohemian rhapsody2018
85,2005-02-11,hitch,55000000,177784257,366784257,2005,189000000,hitch20050211,hitch2005
86,2000-10-06,meet the parents,55000000,166225040,330425040,2000,164200000,meettheparents20001006,meet the parents2000
87,2006-12-15,the pursuit of happyness,55000000,162586036,307311093,2006,144725057,thepursuitofhappyness20061215,the pursuit of happyness2006
91,2017-02-10,fifty shades darker,55000000,114434010,381398492,2017,266964482,fiftyshadesdarker20170210,fifty shades darker2017
92,2013-10-11,captain phillips,55000000,107136417,220648184,2013,113511767,captainphillips20131011,captain phillips2013
94,2003-08-01,american wedding,55000000,104354205,126425115,2003,22070910,americanwedding20030801,american wedding2003
95,2017-11-10,murder on the orient express,55000000,102826543,345922730,2017,243096187,murderontheorientexpress20171110,murder on the orient express2017
96,2014-09-26,the equalizer,55000000,101530738,192903624,2014,91372886,theequalizer20140926,the equalizer2014
97,2018-02-09,fifty shades freed,55000000,100407760,371350619,2018,270942859,fiftyshadesfreed20180209,fifty shades freed2018
99,2010-04-09,date night,55000000,98711404,152269033,2010,53557629,datenight20100409,date night2010
100,2002-12-13,maid in manhattan,55000000,93932896,163838217,2002,69905321,maidinmanhattan20021213,maid in manhattan2002
2,2005-09-23,flightplan,55000000,89706988,214392904,2005,124685916,flightplan20050923,flightplan2005
5,2015-01-16,paddington,55000000,76223578,258789097,2015,182565519,paddington20150116,paddington2015
6,2006-04-28,r.v.,55000000,71724497,87473024,2006,15748527,rv20060428,r.v.2006
8,2003-10-10,kill bill: volume 1,55000000,70098138,176469428,2003,106371290,killbillvolume120031010,kill bill: volume 12003
9,2011-06-17,mr. poppers's penguins,55000000,68224452,189624452,2011,121400000,mrpoppersspenguins20110617,mr. poppers's penguins2011
11,2004-04-16,kill bill: volume 2,55000000,66207920,153535982,2004,87328062,killbillvolume220040416,kill bill: volume 22004
14,2000-05-26,shanghai noon,55000000,56932305,71189835,2000,14257530,shanghainoon20000526,shanghai noon2000
16,2013-11-01,free birds,55000000,55750480,110387072,2013,54636592,freebirds20131101,free birds2013
18,2008-04-18,the forbidden kingdom,55000000,52075270,129075270,2008,77000000,theforbiddenkingdom20080418,the forbidden kingdom2008
19,2004-12-22,the phantom of the opera,55000000,51225796,153770052,2004,102544256,thephantomoftheopera20041222,the phantom of the opera2004
20,2014-03-21,muppets most wanted,55000000,51178893,79312301,2014,28133408,muppetsmostwanted20140321,muppets most wanted2014
22,2016-08-19,kubo and the two strings,55000000,48023088,77548122,2016,29525034,kuboandthetwostrings20160819,kubo and the two strings2016
24,2010-11-24,burlesque,55000000,39440655,90552675,2010,51112020,burlesque20101124,burlesque2010
26,2008-10-24,changeling,55000000,35739802,113805580,2008,78065778,changeling20081024,changeling2008
27,2012-07-27,the watch,55000000,34353000,67130045,2012,32777045,thewatch20120727,the watch2012
28,2003-03-14,the hunted,55000000,34234008,47213095,2003,12979087,thehunted20030314,the hunted2003
30,2003-12-12,stuck on you,55000000,33832741,63537164,2003,29704423,stuckonyou20031212,stuck on you2003
31,2008-02-29,semi-pro,55000000,33479698,43980363,2008,10500665,semipro20080229,semi-pro2008
32,2018-02-23,annihilation,55000000,32732301,43070915,2018,10338614,annihilation20180223,annihilation2018
33,2015-10-16,crimson peak,55000000,31090320,74966854,2015,43876534,crimsonpeak20151016,crimson peak2015
34,2012-04-27,the pirates! band of misfits,55000000,31051126,136143605,2012,105092479,thepiratesbandofmisfits20120427,the pirates! band of misfits2012
35,2005-12-02,aeon flux,55000000,25857987,53913573,2005,28055586,aeonflux20051202,aeon flux2005
38,2007-10-12,elizabeth: the golden age,55000000,16285240,74870866,2007,58585626,elizabeththegoldenage20071012,elizabeth: the golden age2007
39,2009-06-12,imagine that,55000000,16222392,22438144,2009,6215752,imaginethat20090612,imagine that2009
40,2003-02-21,gods and generals,55000000,12882934,12923936,2003,41002,godsandgenerals20030221,gods and generals2003
42,2013-02-01,bullet to the head,55000000,9489829,22597969,2013,13108140,bullettothehead20130201,bullet to the head2013
43,2006-09-22,all the king's men,55000000,7221458,9521458,2006,2300000,allthekingsmen20060922,all the king's men2006
44,2004-07-30,thunderbirds,55000000,6768055,28231444,2004,21463389,thunderbirds20040730,thunderbirds2004
45,2004-11-26,un long dimanche de fianã§ailles,55000000,6167817,69759296,2004,63591479,unlongdimanchedefianãailles20041126,un long dimanche de fianã§ailles2004
46,2007-05-04,lucky you,55000000,5755286,6521829,2007,766543,luckyyou20070504,lucky you2007
48,2002-09-20,eye see you,55000000,79161,1807990,2002,1728829,eyeseeyou20020920,eye see you2002
50,2002-03-22,blade 2,54000000,81676888,154338601,2002,72661713,blade220020322,blade 22002
51,2006-07-14,"you, me and dupree",54000000,75802010,130402010,2006,54600000,youmeanddupree20060714,"you, me and dupree2006"
52,2008-12-19,seven pounds,54000000,69951824,166617328,2008,96665504,sevenpounds20081219,seven pounds2008
54,2005-10-14,elizabethtown,54000000,26850426,50719373,2005,23868947,elizabethtown20051014,elizabethtown2005
55,2003-08-01,gigli,54000000,6087542,7126002,2003,1038460,gigli20030801,gigli2003
56,2000-06-16,shaft,53012938,70327868,107190108,2000,36862240,shaft20000616,shaft2000
57,2005-08-05,the dukes of hazzard,53000000,80270227,109848461,2005,29578234,thedukesofhazzard20050805,the dukes of hazzard2005
58,2009-10-16,law abiding citizen,53000000,73357727,131159781,2009,57802054,lawabidingcitizen20091016,law abiding citizen2009
59,2015-09-18,black mass,53000000,62575678,98837872,2015,36262194,blackmass20150918,black mass2015
61,2001-05-18,moulin rouge,53000000,57386369,179200588,2001,121814219,moulinrouge20010518,moulin rouge2001
62,2001-11-02,domestic disturbance,53000000,45207112,54207112,2001,9000000,domesticdisturbance20011102,domestic disturbance2001
63,2006-10-20,flags of our fathers,53000000,33602376,63657941,2006,30055565,flagsofourfathers20061020,flags of our fathers2006
64,2007-04-06,grindhouse,53000000,25031037,50187789,2007,25156752,grindhouse20070406,grindhouse2007
66,2012-12-19,zero dark thirty,52500000,95720716,134612435,2012,38891719,zerodarkthirty20121219,zero dark thirty2012
67,2002-12-25,catch me if you can,52000000,164606800,355612291,2002,191005491,catchmeifyoucan20021225,catch me if you can2002
68,2008-07-18,mamma mia!,52000000,144130063,615748772,2008,471618709,mammamia20080718,mamma mia!2008
69,2006-06-02,the break-up,52000000,118703275,205727307,2006,87024032,thebreakup20060602,the break-up2006
70,2010-02-12,valentine's day,52000000,110485654,217569328,2010,107083674,valentinesday20100212,valentine's day2010
72,2011-08-05,the change-up,52000000,37243418,75997067,2011,38753649,thechangeup20110805,the change-up2011
75,2010-02-05,from paris with love,52000000,24077427,53139168,2010,29061741,frompariswithlove20100205,from paris with love2010
76,2003-04-16,bulletproof monk,52000000,23010607,23010607,2003,0,bulletproofmonk20030416,bulletproof monk2003
77,2000-06-23,"me, myself & irene",51000000,90570999,149270999,2000,58700000,memyselfirene20000623,"me, myself & irene2000"
78,2006-08-04,barnyard: the original party animals,51000000,72779000,118583844,2006,45804844,barnyardtheoriginalpartyanimals20060804,barnyard: the original party animals2006
79,2018-08-17,alpha,51000000,35851379,99624873,2018,63773494,alpha20180817,alpha2018
80,2006-11-22,deck the halls,51000000,35093569,46815807,2006,11722238,deckthehalls20061122,deck the halls2006
81,2011-03-04,the adjustment bureau,50200000,62495645,126931325,2011,64435680,theadjustmentbureau20110304,the adjustment bureau2011
82,2009-11-20,the twilight saga: new moon,50000000,296623634,687557727,2009,390934093,thetwilightsaganewmoon20091120,the twilight saga: new moon2009
83,2001-05-18,shrek,50000000,267655011,491812794,2001,224157783,shrek20010518,shrek2001
84,2012-06-29,ted,50000000,218665740,556016627,2012,337350887,ted20120629,ted2012
85,2014-06-13,22 jump street,50000000,191719337,331333876,2014,139614539,22jumpstreet20140613,22 jump street2014
88,2015-12-25,daddyâs home,50000000,150357137,242757137,2015,92400000,daddyâshome20151225,daddyâs home2015
91,2016-06-17,central intelligence,50000000,127440871,217194805,2016,89753934,centralintelligence20160617,central intelligence2016
92,2013-12-18,anchorman 2: the legend continues,50000000,127352707,172185754,2013,44833047,anchorman2thelegendcontinues20131218,anchorman 2: the legend continues2013
93,2011-06-10,super 8,50000000,127004179,257972745,2011,130968566,super820110610,super 82011
94,2002-06-28,mr. deeds,50000000,126293452,171269535,2002,44976083,mrdeeds20020628,mr. deeds2002
95,2000-03-17,erin brockovich,50000000,125548685,257805243,2000,132256558,erinbrockovich20000317,erin brockovich2000
96,2018-11-21,creed ii,50000000,115715889,213591522,2018,97875633,creedii20181121,creed ii2018
97,2018-02-09,peter rabbit,50000000,115234093,347136477,2018,231902384,peterrabbit20180209,peter rabbit2018
98,2003-02-07,how to lose a guy in 10 days,50000000,105807520,178890782,2003,73083262,howtoloseaguyin10days20030207,how to lose a guy in 10 days2003
100,2018-12-14,the mule,50000000,103804407,170857676,2018,67053269,themule20181214,the mule2018
1,2008-12-19,yes man,50000000,97690976,225990976,2008,128300000,yesman20081219,yes man2008
2,2014-02-28,non-stop,50000000,91742160,222383055,2014,130640895,nonstop20140228,non-stop2014
4,2013-08-09,disney planes,50000000,90282580,238059569,2013,147776989,disneyplanes20130809,disney planes2013
5,2006-03-10,failure to launch,50000000,88715192,128402901,2006,39687709,failuretolaunch20060310,failure to launch2006
6,2006-03-24,inside man,50000000,88634237,185798265,2006,97164028,insideman20060324,inside man2006
7,2017-07-28,the emoji movie,50000000,86089513,216562312,2017,130472799,theemojimovie20170728,the emoji movie2017
8,2011-07-29,"crazy, stupid, love",50000000,84351197,147142328,2011,62791131,crazystupidlove20110729,"crazy, stupid, love2011"
9,2017-12-22,the post,50000000,81903458,179748880,2017,97845422,thepost20171222,the post2017
12,2009-03-20,knowing,50000000,79957634,186450317,2009,106492683,knowing20090320,knowing2009
13,2005-03-18,the ring two,50000000,75941727,161941727,2005,86000000,theringtwo20050318,the ring two2005
14,2011-12-23,we bought a zoo,50000000,75624550,118729073,2011,43104523,weboughtazoo20111223,we bought a zoo2011
15,2011-09-23,moneyball,50000000,75605492,111300835,2011,35695343,moneyball20110923,moneyball2011
16,2004-06-11,garfield: the movie,50000000,75367693,208094550,2004,132726857,garfieldthemovie20040611,garfield: the movie2004
17,2004-11-24,christmas with the kranks,50000000,73701902,96469187,2004,22767285,christmaswiththekranks20041124,christmas with the kranks2004
18,2006-03-17,v for vendetta,50000000,70511035,130214162,2006,59703127,vforvendetta20060317,v for vendetta2006
20,2009-03-13,race to witch mountain,50000000,67172595,105103784,2009,37931189,racetowitchmountain20090313,race to witch mountain2009
21,2004-09-24,the forgotten,50000000,66711892,117211892,2004,50500000,theforgotten20040924,the forgotten2004
22,2005-06-22,herbie: fully loaded,50000000,66010682,144110682,2005,78100000,herbiefullyloaded20050622,herbie: fully loaded2005
23,2003-02-07,shanghai knights,50000000,60470220,88316835,2003,27846615,shanghaiknights20030207,shanghai knights2003
24,2014-07-18,planes: fire and rescue,50000000,59157732,156399644,2014,97241912,planesfireandrescue20140718,planes: fire and rescue2014
25,2006-02-10,curious george,50000000,58640119,71052604,2006,12412485,curiousgeorge20060210,curious george2006
26,2012-04-06,american reunion,50000000,56758835,236799211,2012,180040376,americanreunion20120406,american reunion2012
27,2013-01-25,hansel & gretel: witch hunters,50000000,55703475,214949716,2013,159246241,hanselgretelwitchhunters20130125,hansel & gretel: witch hunters2013
28,2011-02-18,i am number four,50000000,55100437,146195159,2011,91094722,iamnumberfour20110218,i am number four2011
29,2001-09-28,donât say a word,50000000,54997476,104488383,2001,49490907,donâtsayaword20010928,donât say a word2001
30,2016-01-15,13 hours: the secret soldiers of benghazi,50000000,52853219,69411370,2016,16558151,13hoursthesecretsoldiersofbenghazi20160115,13 hours: the secret soldiers of benghazi2016
31,2002-05-08,unfaithful,50000000,52752475,119114494,2002,66362019,unfaithful20020508,unfaithful2002
32,2017-09-29,american made,50000000,51342000,135569212,2017,84227212,americanmade20170929,american made2017
33,2005-11-23,syriana,50000000,50824620,92690959,2005,41866339,syriana20051123,syriana2005
34,2004-09-10,resident evil: apocalypse,50000000,50740078,125168734,2004,74428656,residentevilapocalypse20040910,resident evil: apocalypse2004
35,2014-10-17,the book of life,50000000,50151543,97651543,2014,47500000,thebookoflife20141017,the book of life2014
37,2006-02-10,firewall,50000000,48751189,82751189,2006,34000000,firewall20060210,firewall2006
40,2014-08-08,into the storm,50000000,47602194,150429371,2014,102827177,intothestorm20140808,into the storm2014
41,2014-10-10,the judge,50000000,47119388,76119388,2014,29000000,thejudge20141010,the judge2014
42,2006-04-21,silent hill,50000000,46982632,94704227,2006,47721595,silenthill20060421,silent hill2006
43,2000-08-11,the replacements,50000000,44737059,50054511,2000,5317452,thereplacements20000811,the replacements2000
45,2016-08-19,war dogs,50000000,43034523,86234503,2016,43199980,wardogs20160819,war dogs2016
49,2003-10-03,out of time,50000000,41083108,55489826,2003,14406718,outoftime20031003,out of time2003
50,2004-11-12,bridget jones: the edge of reason,50000000,40203020,263894551,2004,223691531,bridgetjonestheedgeofreason20041112,bridget jones: the edge of reason2004
51,2000-02-11,the beach,50000000,39778599,39778599,2000,0,thebeach20000211,the beach2000
52,2005-06-10,the adventures of sharkboy and lavagirl in 3-d,50000000,39177684,69425966,2005,30248282,theadventuresofsharkboyandlavagirlin3d20050610,the adventures of sharkboy and lavagirl in 3-d2005
54,2009-11-25,ninja assassin,50000000,38122883,62209892,2009,24087009,ninjaassassin20091125,ninja assassin2009
55,2004-05-28,raising helen,50000000,37485528,49928680,2004,12443152,raisinghelen20040528,raising helen2004
56,2016-05-20,the nice guys,50000000,36261763,59596747,2016,23334984,theniceguys20160520,the nice guys2016
59,2010-06-04,marmaduke,50000000,33644788,89895930,2010,56251142,marmaduke20100604,marmaduke2010
61,2010-10-15,hereafter,50000000,32746941,108660270,2010,75913329,hereafter20101015,hereafter2010
62,2002-04-19,murder by numbers,50000000,31874869,56643267,2002,24768398,murderbynumbers20020419,murder by numbers2002
64,2016-02-12,zoolander 2,50000000,28848693,55348693,2016,26500000,zoolander220160212,zoolander 22016
65,2009-01-16,defiance,50000000,28644813,52987754,2009,24342941,defiance20090116,defiance2009
66,2007-02-09,hannibal rising,50000000,27669725,80583311,2007,52913586,hannibalrising20070209,hannibal rising2007
68,2013-03-29,the host,50000000,26623701,64477051,2013,37853350,thehost20130329,the host2013
69,2003-03-28,basic,50000000,26599248,42598498,2003,15999250,basic20030328,basic2003
70,2015-03-13,run all night,50000000,26461644,66961644,2015,40500000,runallnight20150313,run all night2015
71,2002-08-09,blood work,50000000,26199517,26199517,2002,0,bloodwork20020809,blood work2002
72,2009-02-13,the international,50000000,25450527,53850527,2009,28400000,theinternational20090213,the international2009
74,2004-02-27,twisted,50000000,25195050,40119848,2004,14924798,twisted20040227,twisted2004
75,2004-12-10,the life aquatic with steve zissou,50000000,24006726,34806726,2004,10800000,thelifeaquaticwithstevezissou20041210,the life aquatic with steve zissou2004
77,2019-04-12,hellboy,50000000,21903748,40725492,2019,18821744,hellboy20190412,hellboy2019
78,2011-04-08,your highness,50000000,21596445,26121638,2011,4525193,yourhighness20110408,your highness2011
79,2016-09-16,snowden,50000000,21587519,35380918,2016,13793399,snowden20160916,snowden2016
80,2011-09-30,dream house,50000000,21302340,41642166,2011,20339826,dreamhouse20110930,dream house2011
81,2016-06-24,free state of jones,50000000,20810036,23237252,2016,2427216,freestateofjones20160624,free state of jones2016
82,2009-09-04,gamer,50000000,20534907,42002029,2009,21467122,gamer20090904,gamer2009
83,2005-02-25,man of the house,50000000,19699706,22099706,2005,2400000,manofthehouse20050225,man of the house2005
84,2003-02-21,the life of david gale,50000000,19694635,28920188,2003,9225553,thelifeofdavidgale20030221,the life of david gale2003
85,2013-02-14,beautiful creatures,50000000,19452138,60282876,2013,40830738,beautifulcreatures20130214,beautiful creatures2013
86,2005-09-30,into the blue,50000000,18782227,41982227,2005,23200000,intotheblue20050930,into the blue2005
87,2007-09-14,eastern promises,50000000,17181265,56077088,2007,38895823,easternpromises20070914,eastern promises2007
91,2011-02-25,drive angry,50000000,10721033,41042583,2011,30321550,driveangry20110225,drive angry2011
94,2005-10-14,domino,50000000,10169202,23574057,2005,13404855,domino20051014,domino2005
96,2009-02-27,street fighter: the legend of chun-li,50000000,8742261,12660287,2009,3918026,streetfighterthelegendofchunli20090227,street fighter: the legend of chun-li2009
97,2002-03-29,death to smoochy,50000000,8355815,8374062,2002,18247,deathtosmoochy20020329,death to smoochy2002
98,2018-02-16,early man,50000000,8267544,45285890,2018,37018346,earlyman20180216,early man2018
99,2009-11-13,the boat that rocked,50000000,8017467,37472651,2009,29455184,theboatthatrocked20091113,the boat that rocked2009
100,2004-01-30,the big bounce,50000000,6471394,6626115,2004,154721,thebigbounce20040130,the big bounce2004
1,2000-03-03,what planet are you from?,50000000,6291602,6291602,2000,0,whatplanetareyoufrom20000303,what planet are you from?2000
2,2015-04-17,child 44,50000000,1224330,8004221,2015,6779891,child4420150417,child 442015
3,2009-01-23,outlander,50000000,166003,1250617,2009,1084614,outlander20090123,outlander2009
4,2013-03-15,upside down,50000000,102118,26387039,2013,26284921,upsidedown20130315,upside down2013
5,2015-10-02,shanghai,50000000,46425,15505922,2015,15459497,shanghai20151002,shanghai2015
6,2020-12-31,hannibal the conqueror,50000000,0,0,2020,0,hannibaltheconqueror20201231,hannibal the conqueror2020
7,2019-11-08,arctic dogs,50000000,0,0,2019,0,arcticdogs20191108,arctic dogs2019
8,2019-11-22,the rhythm section,50000000,0,0,2019,0,therhythmsection20191122,the rhythm section2019
9,2019-09-20,ad astra,49800000,0,0,2019,0,adastra20190920,ad astra2019
10,2001-11-02,the one,49000000,43905746,72689126,2001,28783380,theone20011102,the one2001
11,2015-03-06,chappie,49000000,31569268,105002056,2015,73432788,chappie20150306,chappie2015
13,2012-11-16,anna karenina,49000000,12816367,71004627,2012,58188260,annakarenina20121116,anna karenina2012
15,2002-10-18,the ring,48000000,129094024,248218486,2002,119124462,thering20021018,the ring2002
16,2000-12-27,traffic,48000000,124107476,208300000,2000,84192524,traffic20001227,traffic2000
17,2002-03-29,panic room,48000000,95308367,196308367,2002,101000000,panicroom20020329,panic room2002
18,2015-01-09,taken 3,48000000,89256424,327656424,2015,238400000,taken320150109,taken 32015
20,2018-11-16,instant family,48000000,67363237,119736188,2018,52372951,instantfamily20181116,instant family2018
23,2010-01-22,tooth fairy,48000000,60022256,112610386,2010,52588130,toothfairy20100122,tooth fairy2010
24,2001-08-17,rat race,48000000,56607223,86607223,2001,30000000,ratrace20010817,rat race2001
25,2007-09-07,3:10 to yuma,48000000,53606916,71171825,2007,17564909,310toyuma20070907,3:10 to yuma2007
26,2001-08-13,k-pax,48000000,50315140,50315140,2001,0,kpax20010813,k-pax2001
27,2001-12-25,kate and leopold,48000000,47095453,70937778,2001,23842325,kateandleopold20011225,kate and leopold2001
28,2000-10-20,bedazzled,48000000,37879996,90376224,2000,52496228,bedazzled20001020,bedazzled2000
31,2008-01-25,rambo,47500000,42754105,112214531,2008,69460426,rambo20080125,rambo2008
32,2016-07-13,the infiltrator,47500000,15436808,20718104,2016,5281296,theinfiltrator20160713,the infiltrator2016
34,2016-11-11,arrival,47000000,100546139,203127894,2016,102581755,arrival20161111,arrival2016
36,2009-04-22,earth,47000000,32011576,116773317,2009,84761741,earth20090422,earth2009
37,2001-10-19,riding in cars with boys,47000000,29781453,29781453,2001,0,ridingincarswithboys20011019,riding in cars with boys2001
38,2007-01-05,happily n'ever after,47000000,15849032,37923818,2007,22074786,happilyneverafter20070105,happily n'ever after2007
39,2002-11-27,solaris,47000000,14970038,14970038,2002,0,solaris20021127,solaris2002
40,2010-06-18,jonah hex,47000000,10547117,11022696,2010,475579,jonahhex20100618,jonah hex2010
42,2016-12-23,silence,46500000,7100177,23726626,2016,16626449,silence20161223,silence2016
43,2013-11-01,mr. nobody,46500000,3622,22254,2013,18632,mrnobody20131101,mr. nobody2013
45,2001-07-20,america's sweethearts,46000000,93607673,160648493,2001,67040820,americassweethearts20010720,america's sweethearts2001
47,2002-05-24,insomnia,46000000,67263182,113622499,2002,46359317,insomnia20020524,insomnia2002
48,2013-09-20,prisoners,46000000,61002302,113402302,2013,52400000,prisoners20130920,prisoners2013
51,2010-12-31,arthur and the war of two worlds,45500000,347136,36180824,2010,35833688,arthurandthewaroftwoworlds20101231,arthur and the war of two worlds2010
54,2012-10-05,taken 2,45000000,139854287,377807404,2012,237953117,taken220121005,taken 22012
56,2003-10-24,scary movie 3,45000000,110000082,155200000,2003,45199918,scarymovie320031024,scary movie 32003
57,2000-12-22,miss congeniality,45000000,106807667,213420951,2000,106613284,misscongeniality20001222,miss congeniality2000
58,2017-12-22,pitch perfect 3,45000000,104897530,185736412,2017,80838882,pitchperfect320171222,pitch perfect 32017
59,2008-07-11,journey to the center of the earth,45000000,101704370,243180937,2008,141476567,journeytothecenteroftheearth20080711,journey to the center of the earth2008
61,2004-08-11,the princess diaries 2: royal engagement,45000000,95149435,122071435,2004,26922000,theprincessdiaries2royalengagement20040811,the princess diaries 2: royal engagement2004
62,2007-12-25,the bucket list,45000000,93466502,174807445,2007,81340943,thebucketlist20071225,the bucket list2007
64,2011-11-23,the muppets,45000000,88625922,160971922,2011,72346000,themuppets20111123,the muppets2011
66,2005-05-13,monster-in-law,45000000,82931301,155931301,2005,73000000,monsterinlaw20050513,monster-in-law2005
67,2001-10-05,training day,45000000,76261036,104505362,2001,28244326,trainingday20011005,training day2001
68,2016-10-07,the girl on the train,45000000,75395035,174278214,2016,98883179,thegirlonthetrain20161007,the girl on the train2016
70,2001-07-04,scary movie 2,45000000,71277420,141189101,2001,69911681,scarymovie220010704,scary movie 22001
72,2005-01-14,coach carter,45000000,67264877,76665507,2005,9400630,coachcarter20050114,coach carter2005
73,2010-03-19,the bounty hunter,45000000,67061228,135808837,2010,68747609,thebountyhunter20100319,the bounty hunter2010
74,2002-04-12,changing lanes,45000000,66790248,66790248,2002,0,changinglanes20020412,changing lanes2002
76,2006-01-20,underworld: evolution,45000000,62318875,113417762,2006,51098887,underworldevolution20060120,underworld: evolution2006
77,2000-08-04,coyote ugly,45000000,60786269,113916474,2000,53130205,coyoteugly20000804,coyote ugly2000
78,2003-11-07,love actually,45000000,59472278,248505300,2003,189033022,loveactually20031107,love actually2003
81,2016-12-09,office christmas party,45000000,54767494,91323299,2016,36555805,officechristmasparty20161209,office christmas party2016
83,2005-11-23,"yours, mine and ours",45000000,53359917,72359917,2005,19000000,yoursmineandours20051123,"yours, mine and ours2005"
84,2005-05-13,kicking and screaming,45000000,52842724,55842724,2005,3000000,kickingandscreaming20050513,kicking and screaming2005
85,2005-04-29,the hitchhiker's guide to the galaxy,45000000,51019112,102746214,2005,51727102,thehitchhikersguidetothegalaxy20050429,the hitchhiker's guide to the galaxy2005
86,2007-09-21,resident evil: extinction,45000000,50648679,149871103,2007,99222424,residentevilextinction20070921,resident evil: extinction2007
87,2004-12-25,fat albert,45000000,48114556,48563556,2004,449000,fatalbert20041225,fat albert2004
88,2012-07-06,savages,45000000,47323100,82513490,2012,35190390,savages20120706,savages2012
90,2014-05-23,blended,45000000,46290741,127990741,2014,81700000,blended20140523,blended2014
91,2017-06-16,all eyez on me,45000000,44922302,54876855,2017,9954553,alleyezonme20170616,all eyez on me2017
92,2006-01-13,last holiday,45000000,38399961,43343247,2006,4943286,lastholiday20060113,last holiday2006
93,2006-03-03,16 blocks,45000000,36895141,65595141,2006,28700000,16blocks20060303,16 blocks2006
95,2004-09-10,cellular,45000000,32003620,61475984,2004,29472364,cellular20040910,cellular2004
96,2006-07-28,the ant bully,45000000,28142535,49610898,2006,21468363,theantbully20060728,the ant bully2006
97,2003-07-18,johnny english,45000000,28013509,163126676,2003,135113167,johnnyenglish20030718,johnny english2003
99,2009-07-31,aliens in the attic,45000000,25200412,59551283,2009,34350871,aliensintheattic20090731,aliens in the attic2009
100,2007-09-14,across the universe,45000000,24343673,29367143,2007,5023470,acrosstheuniverse20070914,across the universe2007
1,2008-12-26,revolutionary road,45000000,22951340,79604820,2008,56653480,revolutionaryroad20081226,revolutionary road2008
2,2008-08-29,babylon a.d.,45000000,22532572,70216497,2008,47683925,babylonad20080829,babylon a.d.2008
6,2019-05-03,uglydolls,45000000,19894664,24644664,2019,4750000,uglydolls20190503,uglydolls2019
7,2001-01-19,the pledge,45000000,19719930,29406132,2001,9686202,thepledge20010119,the pledge2001
8,2005-12-16,the producers: the movie musical,45000000,19398532,32952995,2005,13554463,theproducersthemoviemusical20051216,the producers: the movie musical2005
10,2005-07-01,rebound,45000000,16809014,17492014,2005,683000,rebound20050701,rebound2005
11,2010-02-19,the ghost writer,45000000,15541549,65532491,2010,49990942,theghostwriter20100219,the ghost writer2010
12,2000-12-22,all the pretty horses,45000000,15527125,18120267,2000,2593142,alltheprettyhorses20001222,all the pretty horses2000
13,2008-09-05,bangkok dangerous,45000000,15298133,46598133,2008,31300000,bangkokdangerous20080905,bangkok dangerous2008
15,2012-09-21,dredd,45000000,13414714,41467606,2012,28052892,dredd20120921,dredd2012
16,2011-10-28,the rum diary,45000000,13109815,21544732,2011,8434917,therumdiary20111028,the rum diary2011
18,2018-12-21,welcome to marwen,45000000,10763520,12874922,2018,2111402,welcometomarwen20181221,welcome to marwen2018
19,2011-10-21,johnny english reborn,45000000,8406711,164640401,2011,156233690,johnnyenglishreborn20111021,johnny english reborn2011
20,2008-09-26,miracle at st. anna,45000000,7916887,9676497,2008,1759610,miracleatstanna20080926,miracle at st. anna2008
21,2002-04-05,big trouble,45000000,7262288,8488871,2002,1226583,bigtrouble20020405,big trouble2002
22,2006-12-21,man cheng jin dai huang jin jia,45000000,6566773,76904429,2006,70337656,manchengjindaihuangjinjia20061221,man cheng jin dai huang jin jia2006
23,2007-11-16,love in the time of cholera,45000000,4617608,31077418,2007,26459810,loveinthetimeofcholera20071116,love in the time of cholera2007
24,2002-12-25,pinocchio,45000000,3681811,31681811,2002,28000000,pinocchio20021225,pinocchio2002
26,2012-12-31,foodfight!,45000000,0,73706,2012,73706,foodfight20121231,foodfight!2012
27,2012-10-12,argo,44500000,136025503,227140757,2012,91115254,argo20121012,argo2012
31,2010-07-30,charlie st. cloud,44000000,31206263,48478084,2010,17271821,charliestcloud20100730,charlie st. cloud2010
33,2014-02-06,the interview,44000000,6105175,12342632,2014,6237457,theinterview20140206,the interview2014
35,2013-06-28,the heat,43000000,159581587,229727774,2013,70146187,theheat20130628,the heat2013
36,2000-12-19,finding forrester,43000000,51768623,80013623,2000,28245000,findingforrester20001219,finding forrester2000
37,2000-04-14,28 days,43000000,37035515,62063972,2000,25028457,28days20000414,28 days2000
38,2005-05-13,danny the dog,43000000,24537621,49037621,2005,24500000,dannythedog20050513,danny the dog2005
39,2002-04-12,the sweetest thing,43000000,24430272,63078756,2002,38648484,thesweetestthing20020412,the sweetest thing2002
40,2018-11-09,the girl in the spiderâs web,43000000,14828555,34983342,2018,20154787,thegirlinthespiderâsweb20181109,the girl in the spiderâs web2018
41,2017-01-06,a monster calls,43000000,3740823,46414530,2017,42673707,amonstercalls20170106,a monster calls2017
42,2011-01-28,the mechanic,42500000,29121498,76347393,2011,47225895,themechanic20110128,the mechanic2011
44,2012-03-16,21 jump street,42000000,138447667,202812429,2012,64364762,21jumpstreet20120316,21 jump street2012
46,2000-06-21,chicken run,42000000,106793915,227793915,2000,121000000,chickenrun20000621,chicken run2000
47,2004-01-16,along came polly,42000000,88073507,173044410,2004,84970903,alongcamepolly20040116,along came polly2004
49,2009-07-10,brã¼no,42000000,60054530,138708527,2009,78653997,brã¼no20090710,brã¼no2009
51,2017-05-12,snatched,42000000,45852178,57852177,2017,11999999,snatched20170512,snatched2017
52,2012-10-12,here comes the boom,42000000,45290318,73239258,2012,27948940,herecomestheboom20121012,here comes the boom2012
53,2002-04-05,high crimes,42000000,41543207,63781100,2002,22237893,highcrimes20020405,high crimes2002
55,2011-03-11,red riding hood,42000000,37662162,91678442,2011,54016280,redridinghood20110311,red riding hood2011
56,2002-01-25,the mothman prophecies,42000000,35228696,56438555,2002,21209859,themothmanprophecies20020125,the mothman prophecies2002
58,2018-12-25,holmes & watson,42000000,30568743,41926605,2018,11357862,holmeswatson20181225,holmes & watson2018
59,2012-01-27,one for the money,42000000,26414527,36197221,2012,9782694,oneforthemoney20120127,one for the money2012
60,2001-03-09,15 minutes,42000000,24375436,56331864,2001,31956428,15minutes20010309,15 minutes2001
61,2005-09-16,lord of war,42000000,24149632,60437727,2005,36288095,lordofwar20050916,lord of war2005
64,2012-01-27,man on a ledge,42000000,18620000,49621440,2012,31001440,manonaledge20120127,man on a ledge2012
65,2010-12-03,the warrior's way,42000000,5666340,8514325,2010,2847985,thewarriorsway20101203,the warrior's way2010
67,2010-05-28,micmacs,42000000,1259693,11756922,2010,10497229,micmacs20100528,micmacs2010
68,2006-12-31,les bronzã©s 3: amis pour la vie,42000000,0,83833602,2006,83833602,lesbronzãs3amispourlavie20061231,les bronzã©s 3: amis pour la vie2006
69,2015-12-31,pourquoi j'ai pas mangã© mon pã¨re,42000000,0,15451663,2015,15451663,pourquoijaipasmangãmonpãre20151231,pourquoi j'ai pas mangã© mon pã¨re2015
70,2002-11-08,8 mile,41000000,116724075,245768384,2002,129044309,8mile20021108,8 mile2002
71,2019-05-31,rocketman,41000000,57342725,108642725,2019,51300000,rocketman20190531,rocketman2019
72,2001-05-11,a knightâs tale,41000000,56083966,100622586,2001,44538620,aknightâstale20010511,a knightâs tale2001
73,2003-08-22,the medallion,41000000,22108977,22108977,2003,0,themedallion20030822,the medallion2003
74,2011-10-14,the big year,41000000,7204138,7684524,2011,480386,thebigyear20111014,the big year2011
76,2005-07-15,wedding crashers,40000000,209218368,283218368,2005,74000000,weddingcrashers20050715,wedding crashers2005
77,2010-06-11,the karate kid,40000000,176591618,351774938,2010,175183320,thekaratekid20100611,the karate kid2010
78,2015-02-13,fifty shades of grey,40000000,166167230,570998101,2015,404830871,fiftyshadesofgrey20150213,fifty shades of grey2015
79,2009-06-19,the proposal,40000000,163958031,314709717,2009,150751686,theproposal20090619,the proposal2009
80,2013-12-13,american hustle,40000000,150117807,257878294,2013,107760487,americanhustle20131213,american hustle2013
81,2019-05-17,john wick: chapter 3 â parabellum,40000000,141744320,256498033,2019,114753713,johnwickchapter3âparabellum20190517,john wick: chapter 3 â parabellum2019
82,2003-12-25,cheaper by the dozen,40000000,138614544,190212113,2003,51597569,cheaperbythedozen20031225,cheaper by the dozen2003
83,2014-07-25,lucy,40000000,126573960,457507776,2014,330933816,lucy20140725,lucy2014
84,2013-12-25,lone survivor,40000000,125095601,149804632,2013,24709031,lonesurvivor20131225,lone survivor2013
87,2003-07-25,spy kids 3-d: game over,40000000,111760631,167851995,2003,56091364,spykids3dgameover20030725,spy kids 3-d: game over2003
90,2016-06-10,the conjuring 2: the enfield poltergeist,40000000,102470008,311262102,2016,208792094,theconjuring2theenfieldpoltergeist20160610,the conjuring 2: the enfield poltergeist2016
91,2010-10-01,the social network,40000000,96962694,224922135,2010,127959441,thesocialnetwork20101001,the social network2010
92,2009-08-07,julie & julia,40000000,94125426,126646119,2009,32520693,juliejulia20090807,julie & julia2009
93,2009-02-06,he's just not that into you,40000000,93953653,181053657,2009,87100004,hesjustnotthatintoyou20090206,he's just not that into you2009
94,2017-02-10,john wick: chapter two,40000000,92029184,171350009,2017,79320825,johnwickchaptertwo20170210,john wick: chapter two2017
95,2016-01-15,ride along 2,40000000,90862685,124827316,2016,33964631,ridealong220160115,ride along 22016
96,2006-04-14,scary movie 4,40000000,90710620,178710620,2006,88000000,scarymovie420060414,scary movie 42006
97,2015-03-27,get hard,40000000,90411453,106511453,2015,16100000,gethard20150327,get hard2015
98,2000-02-04,scream 3,40000000,89138076,161838076,2000,72700000,scream320000204,scream 32000
100,2016-10-14,the accountant,40000000,86260045,152962083,2016,66702038,theaccountant20161014,the accountant2016
1,2014-11-14,dumb and dumber to,40000000,86208010,156553592,2014,70345582,dumbanddumberto20141114,dumb and dumber to2014
2,2014-04-25,the other woman,40000000,83911193,195111193,2014,111200000,theotherwoman20140425,the other woman2014
4,2006-02-17,eight below,40000000,81612565,120455994,2006,38843429,eightbelow20060217,eight below2006
6,2015-09-25,the intern,40000000,75764672,197115710,2015,121351038,theintern20150925,the intern2015
8,2004-10-29,ray,40000000,75305995,124823094,2004,49517099,ray20041029,ray2004
9,2005-04-01,sin city,40000000,74103820,158527918,2005,84424098,sincity20050401,sin city2005
10,2015-10-16,bridge of spies,40000000,72313754,162498338,2015,90184584,bridgeofspies20151016,bridge of spies2015
11,2008-02-22,vantage point,40000000,72266306,150886329,2008,78620023,vantagepoint20080222,vantage point2008
12,2009-03-20,"i love you, man",40000000,72013010,92302502,2009,20289492,iloveyouman20090320,"i love you, man2009"
13,2001-11-09,shallow hal,40000000,70836296,70836296,2001,0,shallowhal20011109,shallow hal2001
15,2006-01-27,big momma's house 2,40000000,70165972,137047376,2006,66881404,bigmommashouse220060127,big momma's house 22006
16,2018-09-21,the house with a clock in its walls,40000000,68549695,126331750,2018,57782055,thehousewithaclockinitswalls20180921,the house with a clock in its walls2018
17,2016-11-04,hacksaw ridge,40000000,67209615,168904682,2016,101695067,hacksawridge20161104,hacksaw ridge2016
18,2001-03-02,the mexican,40000000,66808615,145238250,2001,78429635,themexican20010302,the mexican2001
19,2009-08-28,the final destination,40000000,66477700,187384627,2009,120906927,thefinaldestination20090828,the final destination2009
20,2009-04-17,17 again,40000000,64167069,139474906,2009,75307837,17again20090417,17 again2009
21,2011-02-18,unknown,40000000,63686397,136123083,2011,72436686,unknown20110218,unknown2011
22,2010-06-04,get him to the greek,40000000,61153526,91455875,2010,30302349,gethimtothegreek20100604,get him to the greek2010
23,2003-11-21,gothika,40000000,59588068,141484812,2003,81896744,gothika20031121,gothika2003
24,2001-11-30,behind enemy lines,40000000,58855732,58855732,2001,0,behindenemylines20011130,behind enemy lines2001
25,2011-03-18,the lincoln lawyer,40000000,58009200,87145086,2011,29135886,thelincolnlawyer20110318,the lincoln lawyer2011
26,2004-10-15,shall we dance?,40000000,57887882,118097882,2004,60210000,shallwedance20041015,shall we dance?2004
27,2006-08-25,invincible,40000000,57806952,58501127,2006,694175,invincible20060825,invincible2006
28,2013-02-15,escape from planet earth,40000000,57012977,74156610,2013,17143633,escapefromplanetearth20130215,escape from planet earth2013
31,2014-11-26,horrible bosses 2,40000000,54445357,105945357,2014,51500000,horriblebosses220141126,horrible bosses 22014
32,2002-01-25,the count of monte cristo,40000000,54228104,75389090,2002,21160986,thecountofmontecristo20020125,the count of monte cristo2002
33,2006-10-20,the prestige,40000000,53089891,104407366,2006,51317475,theprestige20061020,the prestige2006
34,2006-06-16,the lake house,40000000,52330111,114830111,2006,62500000,thelakehouse20060616,the lake house2006
35,2010-07-09,predators,40000000,52000688,127234389,2010,75233701,predators20100709,predators2010
36,2012-08-15,the odd life of timothy green,40000000,51853450,55249159,2012,3395709,theoddlifeoftimothygreen20120815,the odd life of timothy green2012
38,2006-12-08,apocalypto,40000000,50866635,121032272,2006,70165637,apocalypto20061208,apocalypto2006
39,2007-02-14,music and lyrics,40000000,50572589,146196885,2007,95624296,musicandlyrics20070214,music and lyrics2007
41,2004-03-12,secret window,40000000,47958031,92111551,2004,44153520,secretwindow20040312,secret window2004
42,2005-08-12,the skeleton key,40000000,47907715,92256918,2005,44349203,theskeletonkey20050812,the skeleton key2005
43,2014-06-20,jersey boys,40000000,47047013,65282732,2014,18235719,jerseyboys20140620,jersey boys2014
44,2008-05-02,made of honor,40000000,46012734,106548738,2008,60536004,madeofhonor20080502,made of honor2008
48,2014-05-30,a million ways to die in the west,40000000,42720965,86778557,2014,44057592,amillionwaystodieinthewest20140530,a million ways to die in the west2014
49,2011-08-12,final destination 5,40000000,42587643,155011165,2011,112423522,finaldestination520110812,final destination 52011
50,2018-11-16,widows,40000000,42402632,73866088,2018,31463456,widows20181116,widows2018
51,2005-04-08,fever pitch,40000000,42071069,50071069,2005,8000000,feverpitch20050408,fever pitch2005
52,2007-12-25,aliens vs. predator - requiem,40000000,41797066,128884494,2007,87087428,aliensvspredatorrequiem20071225,aliens vs. predator - requiem2007
53,2007-12-25,the water horse: legend of the deep,40000000,40412817,103429755,2007,63016938,thewaterhorselegendofthedeep20071225,the water horse: legend of the deep2007
54,2014-07-18,sex tape,40000000,38543473,126069509,2014,87526036,sextape20140718,sex tape2014
55,2011-04-15,scream 4,40000000,38180928,95989590,2011,57808662,scream420110415,scream 42011
57,2000-08-11,autumn in new york,40000000,37752931,90717684,2000,52964753,autumninnewyork20000811,autumn in new york2000
58,2011-03-18,paul,40000000,37412945,101162106,2011,63749161,paul20110318,paul2011
59,2012-12-19,the guilt trip,40000000,37134215,41294674,2012,4160459,theguilttrip20121219,the guilt trip2012
60,2011-08-26,colombiana,40000000,36665854,72295262,2011,35629408,colombiana20110826,colombiana2011
62,2018-01-12,the commuter,40000000,36343858,101985431,2018,65641573,thecommuter20180112,the commuter2018
63,2000-02-18,hanging up,40000000,36037909,51867723,2000,15829814,hangingup20000218,hanging up2000
66,2000-10-20,pay it forward,40000000,33508922,55696705,2000,22187783,payitforward20001020,pay it forward2000
67,2011-04-08,arthur,40000000,33035397,47787943,2011,14752546,arthur20110408,arthur2011
68,2008-03-21,drillbit taylor,40000000,32862104,49686263,2008,16824159,drillbittaylor20080321,drillbit taylor2008
69,2016-12-21,patriots day,40000000,31886361,52837989,2016,20951628,patriotsday20161221,patriots day2016
70,2011-12-25,extremely loud and incredibly close,40000000,31847881,55247881,2011,23400000,extremelyloudandincrediblyclose20111225,extremely loud and incredibly close2011
72,2008-11-26,transporter 3,40000000,31715062,107235592,2008,75520530,transporter320081126,transporter 32008
73,2010-11-10,morning glory,40000000,31011732,59795070,2010,28783338,morningglory20101110,morning glory2010
74,2005-11-09,get rich or die tryin',40000000,30981850,46666955,2005,15685105,getrichordietryin20051109,get rich or die tryin'2005
75,2019-05-03,long shot,40000000,30202860,43711031,2019,13508171,longshot20190503,long shot2019
76,2000-08-25,the art of war,40000000,30199105,30199105,2000,0,theartofwar20000825,the art of war2000
77,2013-12-25,grudge match,40000000,29807260,69807260,2013,40000000,grudgematch20131225,grudge match2013
78,2000-08-11,bless the child,40000000,29374178,40435694,2000,11061516,blessthechild20000811,bless the child2000
79,2005-11-23,rent,40000000,29077547,31670620,2005,2593073,rent20051123,rent2005
81,2017-08-11,the nut job 2: nutty by nature,40000000,28370522,57438389,2017,29067867,thenutjob2nuttybynature20170811,the nut job 2: nutty by nature2017
83,2001-09-07,the musketeer,40000000,27053815,27053815,2001,0,themusketeer20010907,the musketeer2001
84,2017-01-27,resident evil: the final chapter,40000000,26844692,314101190,2017,287256498,residentevilthefinalchapter20170127,resident evil: the final chapter2017
85,2008-02-29,the other boleyn girl,40000000,26814957,78269970,2008,51455013,theotherboleyngirl20080229,the other boleyn girl2008
86,2017-06-30,the house,40000000,25584504,31192425,2017,5607921,thehouse20170630,the house2017
87,2001-02-16,sweet november,40000000,25288103,65754228,2001,40466125,sweetnovember20010216,sweet november2001
88,2007-04-05,the reaping,40000000,25126214,62226214,2007,37100000,thereaping20070405,the reaping2007
89,2011-01-07,season of the witch,40000000,24827228,91126600,2011,66299372,seasonofthewitch20110107,season of the witch2011
92,2002-09-06,city by the sea,40000000,22433915,22433915,2002,0,citybythesea20020906,city by the sea2002
94,2016-08-26,mechanic: resurrection,40000000,21218403,109738840,2016,88520437,mechanicresurrection20160826,mechanic: resurrection2016
95,2004-01-16,torque,40000000,21176322,46176322,2004,25000000,torque20040116,torque2004
96,2009-11-13,fantastic mr. fox,40000000,21002919,47083412,2009,26080493,fantasticmrfox20091113,fantastic mr. fox2009
99,2012-02-03,big miracle,40000000,20157300,25268680,2012,5111380,bigmiracle20120203,big miracle2012
100,2012-12-21,the impossible,40000000,19019882,169590606,2012,150570724,theimpossible20121221,the impossible2012
1,2012-03-09,a thousand words,40000000,18450127,20790486,2012,2340359,athousandwords20120309,a thousand words2012
2,2006-10-20,marie antoinette,40000000,15962471,60862471,2006,44900000,marieantoinette20061020,marie antoinette2006
3,2000-10-06,get carter,40000000,14967182,19417182,2000,4450000,getcarter20001006,get carter2000
5,2002-04-26,"life, or something like it",40000000,14448589,14448589,2002,0,lifeorsomethinglikeit20020426,"life, or something like it2002"
8,2009-10-23,amelia,40000000,14279575,19756077,2009,5476502,amelia20091023,amelia2009
9,2009-10-23,cirque du freak: the vampire's assistant,40000000,14046595,39753957,2009,25707362,cirquedufreakthevampiresassistant20091023,cirque du freak: the vampire's assistant2009
10,2004-05-07,new york minute,40000000,14018364,21215882,2004,7197518,newyorkminute20040507,new york minute2004
12,2004-11-05,alfie,40000000,13395939,35195939,2004,21800000,alfie20041105,alfie2004
13,2002-08-30,feardotcom,40000000,13208023,13208023,2002,0,feardotcom20020830,feardotcom2002
14,2008-11-07,soul men,40000000,12082391,12345883,2008,263492,soulmen20081107,soul men2008
15,2015-03-20,the gunman,40000000,10664749,18594227,2015,7929478,thegunman20150320,the gunman2015
17,2009-09-25,pandorum,40000000,10330853,17033431,2009,6702578,pandorum20090925,pandorum2009
18,2003-09-26,duplex,40000000,9652000,10070651,2003,418651,duplex20030926,duplex2003
19,2013-08-16,paranoia,40000000,7388654,16340767,2013,8952113,paranoia20130816,paranoia2013
21,2015-07-10,baahubali: the beginning,40000000,6738000,26736665,2015,19998665,baahubalithebeginning20150710,baahubali: the beginning2015
22,2018-03-09,the hurricane heist,40000000,6115824,30963684,2018,24847860,thehurricaneheist20180309,the hurricane heist2018
23,2002-01-04,impostor,40000000,6114237,7974607,2002,1860370,impostor20020104,impostor2002
24,2015-11-25,victor frankenstein,40000000,5775076,31124367,2015,25349291,victorfrankenstein20151125,victor frankenstein2015
25,2002-11-27,extreme ops,40000000,4835968,12624471,2002,7788503,extremeops20021127,extreme ops2002
26,2001-04-06,just visiting,40000000,4777007,16172200,2001,11395193,justvisiting20010406,just visiting2001
27,2014-06-27,snowpiercer,40000000,4563029,88069880,2014,83506851,snowpiercer20140627,snowpiercer2014
28,2007-07-20,sunshine,40000000,3688560,32030610,2007,28342050,sunshine20070720,sunshine2007
30,2016-11-11,billy lynnâs long halftime walk,40000000,1738477,30230402,2016,28491925,billylynnâslonghalftimewalk20161111,billy lynnâs long halftime walk2016
32,2008-12-12,delgo,40000000,915840,915840,2008,0,delgo20081212,delgo2008
33,2007-09-07,the hunting party,40000000,876671,7729552,2007,6852881,thehuntingparty20070907,the hunting party2007
34,2006-10-13,alex rider: operation stormbreaker,40000000,659210,20722450,2006,20063240,alexrideroperationstormbreaker20061013,alex rider: operation stormbreaker2006
35,2009-11-20,red cliff,40000000,627047,119627047,2009,119000000,redcliff20091120,red cliff2009
36,2004-09-24,the last shot,40000000,463730,463730,2004,0,thelastshot20040924,the last shot2004
37,2007-03-16,nomad,40000000,79123,79123,2007,0,nomad20070316,nomad2007
38,2013-04-16,un monstre ã paris,40000000,0,27000381,2013,27000381,unmonstreãparis20130416,un monstre ã paris2013
39,2019-06-21,kursk,40000000,0,4212799,2019,4212799,kursk20190621,kursk2019
40,2016-11-11,uss indianapolis: men of courage,40000000,0,1663785,2016,1663785,ussindianapolismenofcourage20161111,uss indianapolis: men of courage2016
41,2014-12-31,dragon nest warriors' dawn,40000000,0,734423,2014,734423,dragonnestwarriorsdawn20141231,dragon nest warriors' dawn2014
42,2018-12-31,the crow,40000000,0,0,2018,0,thecrow20181231,the crow2018
43,2019-09-13,the goldfinch,40000000,0,0,2019,0,thegoldfinch20190913,the goldfinch2019
44,2019-12-31,down under cover,40000000,0,0,2019,0,downundercover20191231,down under cover2019
45,2009-08-14,the time traveler's wife,39000000,63414846,102332135,2009,38917289,thetimetravelerswife20090814,the time traveler's wife2009
47,2007-02-02,because i said so,39000000,42674040,69538833,2007,26864793,becauseisaidso20070202,because i said so2007
48,2012-10-05,frankenweenie,39000000,35287788,81150788,2012,45863000,frankenweenie20121005,frankenweenie2012
50,2005-09-30,serenity,39000000,25514517,40319440,2005,14804923,serenity20050930,serenity2005
51,2007-09-07,shoot 'em up,39000000,12796824,26796824,2007,14000000,shootemup20070907,shoot 'em up2007
52,2004-02-20,against the ropes,39000000,5881504,6429865,2004,548361,againsttheropes20040220,against the ropes2004
53,2013-08-23,yi dai zong shi,38600000,6594959,57987299,2013,51392340,yidaizongshi20130823,yi dai zong shi2013
54,2001-06-22,the fast and the furious,38000000,144512310,206512310,2001,62000000,thefastandthefurious20010622,the fast and the furious2001
55,2002-09-27,sweet home alabama,38000000,127214072,182365114,2002,55151042,sweethomealabama20020927,sweet home alabama2002
56,2009-07-24,the ugly truth,38000000,88915214,205298907,2009,116383693,theuglytruth20090724,the ugly truth2009
57,2002-08-07,spy kids 2: the island of lost dreams,38000000,85846296,119721296,2002,33875000,spykids2theislandoflostdreams20020807,spy kids 2: the island of lost dreams2002
59,2017-06-02,captain underpants: the first epic movie,38000000,73921000,126577874,2017,52656874,captainunderpantsthefirstepicmovie20170602,captain underpants: the first epic movie2017
60,2015-04-17,paul blart: mall cop 2,38000000,71091594,107650646,2015,36559052,paulblartmallcop220150417,paul blart: mall cop 22015
62,2016-12-23,why him?,38000000,60323786,117425156,2016,57101370,whyhim20161223,why him?2016
63,2011-04-22,water for elephants,38000000,58709717,116809717,2011,58100000,waterforelephants20110422,water for elephants2011
64,2010-10-08,life as we know it,38000000,53374681,105887837,2010,52513156,lifeasweknowit20101008,life as we know it2010
66,2013-09-06,riddick,38000000,42025135,94763758,2013,52738623,riddick20130906,riddick2013
67,2001-03-23,heartbreakers,38000000,40334024,57753825,2001,17419801,heartbreakers20010323,heartbreakers2001
68,2002-05-24,enough,38000000,39177215,50970660,2002,11793445,enough20020524,enough2002
69,2016-01-22,the 5th wave,38000000,34912982,111336398,2016,76423416,the5thwave20160122,the 5th wave2016
70,2009-02-06,push,38000000,31811527,49678401,2009,17866874,push20090206,push2009
71,2013-09-20,rush,38000000,26947624,98230839,2013,71283215,rush20130920,rush2013
72,2001-05-18,angel eyes,38000000,24044532,29544532,2001,5500000,angeleyes20010518,angel eyes2001
73,2001-12-21,joe somebody,38000000,22770864,24515990,2001,1745126,joesomebody20011221,joe somebody2001
74,2000-03-10,the ninth gate,38000000,18653746,58394308,2000,39740562,theninthgate20000310,the ninth gate2000
75,2017-10-20,only the brave,38000000,18340051,24555177,2017,6215126,onlythebrave20171020,only the brave2017
77,2011-10-14,the thing,38000000,16999934,27573078,2011,10573144,thething20111014,the thing2011
78,2001-09-07,rock star,38000000,16991902,19317765,2001,2325863,rockstar20010907,rock star2001
80,2008-10-10,city of ember,38000000,7873007,17831558,2008,9958551,cityofember20081010,city of ember2008
82,2018-09-21,the sisters brothers,38000000,3143056,13143056,2018,10000000,thesistersbrothers20180921,the sisters brothers2018
83,2001-11-30,texas rangers,38000000,623374,623374,2001,0,texasrangers20011130,texas rangers2001
84,2008-08-26,virgin territory,38000000,0,5473041,2008,5473041,virginterritory20080826,virgin territory2008
85,2019-01-11,the upside,37500000,108235497,119024536,2019,10789039,theupside20190111,the upside2019
86,2012-05-18,what to expect when you're expecting,37500000,41152203,88473016,2012,47320813,whattoexpectwhenyoureexpecting20120518,what to expect when you're expecting2012
87,2012-09-14,the master,37500000,16247159,50647416,2012,34400257,themaster20120914,the master2012
88,2008-10-10,the express,37500000,9793406,9813309,2008,19903,theexpress20081010,the express2008
89,2008-11-21,twilight,37000000,192769854,402280159,2008,209510305,twilight20081121,twilight2008
90,2013-08-07,we're the millers,37000000,150394119,267816276,2013,117422157,werethemillers20130807,we're the millers2013
91,2015-11-25,creed,37000000,109767581,173567581,2015,63800000,creed20151125,creed2015
92,2010-09-17,the town,37000000,92186262,152566881,2010,60380619,thetown20100917,the town2010
93,2011-09-23,dolphin tale,37000000,72286779,96068724,2011,23781945,dolphintale20110923,dolphin tale2011
94,2018-02-23,game night,37000000,69179066,117378084,2018,48199018,gamenight20180223,game night2018
95,2008-09-12,burn after reading,37000000,60355347,168167798,2008,107812451,burnafterreading20080912,burn after reading2008
96,2004-04-23,13 going on 30,37000000,57139723,97658712,2004,40518989,13goingon3020040423,13 going on 302004
97,2008-04-04,nim's island,37000000,48006762,101857425,2008,53850663,nimsisland20080404,nim's island2008
98,2016-02-12,how to be single,37000000,46843513,100003780,2016,53160267,howtobesingle20160212,how to be single2016
99,2010-02-26,cop out,37000000,44875481,55909910,2010,11034429,copout20100226,cop out2010
100,2011-01-28,the rite,37000000,33047633,97143987,2011,64096354,therite20110128,the rite2011
1,2008-07-18,space chimps,37000000,30105968,67029956,2008,36923988,spacechimps20080718,space chimps2008
3,2015-05-29,aloha,37000000,21052030,25387091,2015,4335061,aloha20150529,aloha2015
4,2009-12-31,obitaemyy ostrov,36500000,0,15000000,2009,15000000,obitaemyyostrov20091231,obitaemyy ostrov2009
5,2018-10-05,a star is born,36000000,215288866,433449571,2018,218160705,astarisborn20181005,a star is born2018
6,2011-02-11,gnomeo and juliet,36000000,99967670,193737977,2011,93770307,gnomeoandjuliet20110211,gnomeo and juliet2011
7,2002-02-15,john q,36000000,71026631,102226631,2002,31200000,johnq20020215,john q2002
10,2010-03-26,hot tub time machine,36000000,50269859,65967750,2010,15697891,hottubtimemachine20100326,hot tub time machine2010
12,2014-09-12,dolphin tale 2,36000000,42024533,57824533,2014,15800000,dolphintale220140912,dolphin tale 22014
13,2016-12-16,collateral beauty,36000000,31016021,85309093,2016,54293072,collateralbeauty20161216,collateral beauty2016
14,2003-04-04,a man apart,36000000,26500000,43797731,2003,17297731,amanapart20030404,a man apart2003
15,2000-02-25,reindeer games,36000000,23360779,23360779,2000,0,reindeergames20000225,reindeer games2000
19,2000-01-28,isn't she great,36000000,2954405,2954405,2000,0,isntshegreat20000128,isn't she great2000
20,2016-01-22,yip man 3,36000000,2679437,157300954,2016,154621517,yipman320160122,yip man 32016
21,2011-05-06,there be dragons,36000000,1069334,4020990,2011,2951656,therebedragons20110506,there be dragons2011
22,2017-04-14,queen of the desert,36000000,0,1578543,2017,1578543,queenofthedesert20170414,queen of the desert2017
23,2003-03-28,head of state,35200000,37788228,38283765,2003,495537,headofstate20030328,head of state2003
24,2017-09-08,it,35000000,327481748,697457969,2017,369976221,it20170908,it2017
25,2009-06-05,the hangover,35000000,277322503,465764086,2009,188441583,thehangover20090605,the hangover2009
26,2009-11-20,the blind side,35000000,255959475,305705794,2009,49746319,theblindside20091120,the blind side2009
29,2010-12-22,true grit,35000000,171243005,252276928,2010,81033923,truegrit20101222,true grit2010
32,2013-02-08,identity thief,35000000,134506920,175361578,2013,40854658,identitythief20130208,identity thief2013
33,2006-06-30,the devil wears prada,35000000,124740460,326073155,2006,201332695,thedevilwearsprada20060630,the devil wears prada2006
34,2011-07-08,horrible bosses,35000000,117538559,212417601,2011,94879042,horriblebosses20110708,horrible bosses2011
35,2001-03-30,spy kids,35000000,112692062,197692062,2001,85000000,spykids20010330,spy kids2001
36,2015-07-17,trainwreck,35000000,110212700,141123897,2015,30911197,trainwreck20150717,trainwreck2015
37,2013-12-13,saving mr. banks,35000000,83299761,114962525,2013,31662764,savingmrbanks20131213,saving mr. banks2013
39,2008-03-28,21,35000000,81159365,159846429,2008,78687064,2120080328,212008
40,2008-05-09,what happens in vegas...,35000000,80277646,218535708,2008,138258062,whathappensinvegas20080509,what happens in vegas...2008
43,2009-01-16,hotel for dogs,35000000,73178547,122357172,2009,49178625,hotelfordogs20090116,hotel for dogs2009
44,2005-03-25,guess who,35000000,68915888,102115888,2005,33200000,guesswho20050325,guess who2005
45,2012-12-21,this is 40,35000000,67544505,90221182,2012,22676677,thisis4020121221,this is 402012
47,2005-07-29,sky high,35000000,63939454,83109359,2005,19169905,skyhigh20050729,sky high2005
49,2010-04-30,a nightmare on elm street,35000000,63075011,117729621,2010,54654610,anightmareonelmstreet20100430,a nightmare on elm street2010
50,2000-08-18,the cell,35000000,61280963,85911226,2000,24630263,thecell20000818,the cell2000
52,2006-04-07,the benchwarmers,35000000,59843754,65063726,2006,5219972,thebenchwarmers20060407,the benchwarmers2006
53,2010-10-08,secretariat,35000000,59699513,60376247,2010,676734,secretariat20101008,secretariat2010
55,2011-07-22,friends with benefits,35000000,55802754,146595891,2011,90793137,friendswithbenefits20110722,friends with benefits2011
56,2016-05-20,neighbors 2: sorority rising,35000000,55340730,108757621,2016,53416891,neighbors2sororityrising20160520,neighbors 2: sorority rising2016
57,2007-03-23,tmnt,35000000,54149098,96096018,2007,41946920,tmnt20070323,tmnt2007
58,2003-10-24,radio,35000000,52333738,53293628,2003,959890,radio20031024,radio2003
59,2018-06-29,sicario: day of the soldado,35000000,50065850,75885196,2018,25819346,sicariodayofthesoldado20180629,sicario: day of the soldado2018
60,2009-11-25,old dogs,35000000,49492060,95104304,2009,45612244,olddogs20091125,old dogs2009
62,2015-05-22,poltergeist,35000000,47425125,95713069,2015,48287944,poltergeist20150522,poltergeist2015
63,2018-10-12,goosebumps 2: haunted halloween,35000000,46697321,93291478,2018,46594157,goosebumps2hauntedhalloween20181012,goosebumps 2: haunted halloween2018
64,2018-01-19,12 strong,35000000,45819713,71118378,2018,25298665,12strong20180119,12 strong2018
65,2009-01-23,underworld 3: rise of the lycans,35000000,45802315,89102315,2009,43300000,underworld3riseofthelycans20090123,underworld 3: rise of the lycans2009
66,2005-07-29,must love dogs,35000000,43894863,58405313,2005,14510450,mustlovedogs20050729,must love dogs2005
67,2007-07-03,license to wed,35000000,43799818,70187088,2007,26387270,licensetowed20070703,license to wed2007
69,2008-10-17,max payne,35000000,40689393,87775050,2008,47085657,maxpayne20081017,max payne2008
70,2002-03-15,resident evil,35000000,40119709,103787401,2002,63667692,residentevil20020315,resident evil2002
71,2004-03-26,the ladykillers,35000000,39692139,77392139,2004,37700000,theladykillers20040326,the ladykillers2004
72,2011-05-06,something borrowed,35000000,39046489,65084116,2011,26037627,somethingborrowed20110506,something borrowed2011
73,2006-12-01,the nativity story,35000000,37629831,46309644,2006,8679813,thenativitystory20061201,the nativity story2006
74,2011-10-28,in time,35000000,37553932,165103952,2011,127550020,intime20111028,in time2011
75,2010-04-23,the back-up plan,35000000,37490007,75281179,2010,37791172,thebackupplan20100423,the back-up plan2010
76,2011-11-09,j. edgar,35000000,37306030,84606030,2011,47300000,jedgar20111109,j. edgar2011
77,2000-11-17,bounce,35000000,36805288,53425292,2000,16620004,bounce20001117,bounce2000
78,2018-08-17,mile 22,35000000,36108758,66295121,2018,30186363,mile2220180817,mile 222018
79,2015-05-08,hot pursuit,35000000,34580201,45671512,2015,11091311,hotpursuit20150508,hot pursuit2015
80,2015-12-25,concussion,35000000,34531832,50363790,2015,15831958,concussion20151225,concussion2015
81,2017-10-13,the foreigner,35000000,34393507,140783360,2017,106389853,theforeigner20171013,the foreigner2017
82,2004-12-03,closer,35000000,33987757,116177695,2004,82189938,closer20041203,closer2004
84,2001-11-21,black knight,35000000,33422806,33422806,2001,0,blackknight20011121,black knight2001
85,2005-07-22,the bad news bears,35000000,32868349,33500620,2005,632271,thebadnewsbears20050722,the bad news bears2005
86,2002-12-27,the pianist,35000000,32519322,111854182,2002,79334860,thepianist20021227,the pianist2002
87,2005-05-06,house of wax,35000000,32064800,70064800,2005,38000000,houseofwax20050506,house of wax2005
88,2001-10-19,from hell,35000000,31598308,68712365,2001,37114057,fromhell20011019,from hell2001
89,2018-06-01,adrift,35000000,31445011,57897191,2018,26452180,adrift20180601,adrift2018
90,2008-08-15,mirrors,35000000,30691439,77220596,2008,46529157,mirrors20080815,mirrors2008
91,2017-01-06,underworld: blood wars,35000000,30353973,81209222,2017,50855249,underworldbloodwars20170106,underworld: blood wars2017
92,2002-02-22,queen of the damned,35000000,30307804,30307804,2002,0,queenofthedamned20020222,queen of the damned2002
93,2010-08-20,nanny mcphee and the big bang,35000000,29197642,97799865,2010,68602223,nannymcpheeandthebigbang20100820,nanny mcphee and the big bang2010
94,2008-01-25,untraceable,35000000,28687835,52649951,2008,23962116,untraceable20080125,untraceable2008
96,2011-09-23,abduction,35000000,28087155,86648359,2011,58561204,abduction20110923,abduction2011
98,2008-03-28,superhero movie,35000000,26638520,73026302,2008,46387782,superheromovie20080328,superhero movie2008
100,2012-10-19,alex cross,35000000,25888412,35426759,2012,9538347,alexcross20121019,alex cross2012
1,2004-03-26,jersey girl,35000000,25266129,37066129,2004,11800000,jerseygirl20040326,jersey girl2004
3,2016-09-16,bridget jonesâs baby,35000000,24139805,205822688,2016,181682883,bridgetjonesâsbaby20160916,bridget jonesâs baby2016
4,2001-11-09,heist,35000000,23483357,28906817,2001,5423460,heist20011109,heist2001
6,2016-03-04,whiskey tango foxtrot,35000000,23083334,25350747,2016,2267413,whiskeytangofoxtrot20160304,whiskey tango foxtrot2016
7,2004-04-09,ella enchanted,35000000,22913677,22913677,2004,0,ellaenchanted20040409,ella enchanted2004
8,2015-08-21,hitman: agent 47,35000000,22467450,82182803,2015,59715353,hitmanagent4720150821,hitman: agent 472015
9,2008-07-25,the x-files: i want to believe,35000000,20982478,68170792,2008,47188314,thexfilesiwanttobelieve20080725,the x-files: i want to believe2008
10,2012-08-24,premium rush,35000000,20275446,31393201,2012,11117755,premiumrush20120824,premium rush2012
11,2013-01-18,broken city,35000000,19701164,34480045,2013,14778881,brokencity20130118,broken city2013
12,2005-08-19,valiant,35000000,19478106,64188387,2005,44710281,valiant20050819,valiant2005
13,2000-02-23,wonder boys,35000000,19389454,33422485,2000,14033031,wonderboys20000223,wonder boys2000
14,2005-02-25,cursed,35000000,19294901,25114901,2005,5820000,cursed20050225,cursed2005
15,2007-12-21,walk hard: the dewey cox story,35000000,18317151,20606053,2007,2288902,walkhardthedeweycoxstory20071221,walk hard: the dewey cox story2007
16,2002-09-20,the four feathers,35000000,18306166,29882645,2002,11576479,thefourfeathers20020920,the four feathers2002
17,2010-04-30,furry vengeance,35000000,17630465,39340177,2010,21709712,furryvengeance20100430,furry vengeance2010
18,2013-01-25,parker,35000000,17616641,48543388,2013,30926747,parker20130125,parker2013
19,2004-09-17,wimbledon,35000000,16862585,41666476,2004,24803891,wimbledon20040917,wimbledon2004
20,2000-09-15,bait,35000000,15325127,15471969,2000,146842,bait20000915,bait2000
21,2000-12-08,dungeons and dragons,35000000,15185241,33771965,2000,18586724,dungeonsanddragons20001208,dungeons and dragons2000
22,2007-11-09,lions for lambs,35000000,14998070,63211088,2007,48213018,lionsforlambs20071109,lions for lambs2007
24,2011-05-27,the tree of life,35000000,13305665,61721826,2011,48416161,thetreeoflife20110527,the tree of life2011
25,2001-08-17,american outlaws,35000000,13264986,13601109,2001,336123,americanoutlaws20010817,american outlaws2001
26,2006-08-11,zoom,35000000,11989328,12506188,2006,516860,zoom20060811,zoom2006
27,2001-12-25,the shipping news,35000000,11405825,24405825,2001,13000000,theshippingnews20011225,the shipping news2001
28,2009-12-18,the young victoria,35000000,11001272,31878891,2009,20877619,theyoungvictoria20091218,the young victoria2009
29,2014-03-28,sabotage,35000000,10508518,18376443,2014,7867925,sabotage20140328,sabotage2014
31,2009-09-11,whiteout,35000000,10275638,12254746,2009,1979108,whiteout20090911,whiteout2009
32,2015-03-06,unfinished business,35000000,10219501,13214051,2015,2994550,unfinishedbusiness20150306,unfinished business2015
33,2015-09-30,the walk,35000000,10161183,61492104,2015,51330921,thewalk20150930,the walk2015
34,2006-11-22,the fountain,35000000,10144010,15461638,2006,5317628,thefountain20061122,the fountain2006
35,2013-11-29,mandela: long walk to freedom,35000000,8323085,29890402,2013,21567317,mandelalongwalktofreedom20131129,mandela: long walk to freedom2013
36,2008-12-05,punisher: war zone,35000000,8050977,10157534,2008,2106557,punisherwarzone20081205,punisher: war zone2008
37,2003-09-05,the order,35000000,7659747,11559747,2003,3900000,theorder20030905,the order2003
38,2006-11-10,a good year,35000000,7459300,42064105,2006,34604805,agoodyear20061110,a good year2006
39,2016-03-11,the brothers grimsby,35000000,6864016,28720470,2016,21856454,thebrothersgrimsby20160311,the brothers grimsby2016
40,2017-10-20,the snowman,35000000,6670765,43226146,2017,36555381,thesnowman20171020,the snowman2017
41,2002-11-06,femme fatale,35000000,6630252,16830252,2002,10200000,femmefatale20021106,femme fatale2002
43,2003-09-26,luther,35000000,5781086,32717063,2003,26935977,luther20030926,luther2003
44,2011-01-28,biutiful,35000000,5101237,24687524,2011,19586287,biutiful20110128,biutiful2011
47,2016-04-22,a hologram for the king,35000000,4212494,11846010,2016,7633516,ahologramfortheking20160422,a hologram for the king2016
53,2012-09-14,stolen,35000000,289773,17967746,2012,17677973,stolen20120914,stolen2012
54,2011-10-14,trespass,35000000,16816,786532,2011,769716,trespass20111014,trespass2011
55,2006-09-22,bandidas,35000000,0,19282590,2006,19282590,bandidas20060922,bandidas2006
56,2015-03-13,the lovers,35000000,0,53899,2015,53899,thelovers20150313,the lovers2015
57,2008-12-31,black water transit,35000000,0,0,2008,0,blackwatertransit20081231,black water transit2008
58,2011-12-25,the darkest hour,34800000,21443494,62831715,2011,41388221,thedarkesthour20111225,the darkest hour2011
59,2017-06-28,baby driver,34000000,107825862,228104185,2017,120278323,babydriver20170628,baby driver2017
60,2014-09-19,the maze runner,34000000,102427862,348319861,2014,245891999,themazerunner20140919,the maze runner2014
61,2015-04-10,the longest ride,34000000,37446117,63802928,2015,26356811,thelongestride20150410,the longest ride2015
63,2009-08-14,gake no ue no ponyo,34000000,15090399,205312666,2009,190222267,gakenouenoponyo20090814,gake no ue no ponyo2009
64,2018-08-03,the darkest minds,34000000,12695691,38361428,2018,25665737,thedarkestminds20180803,the darkest minds2018
67,2000-05-05,i dreamed of africa,34000000,6543194,14291999,2000,7748805,idreamedofafrica20000505,i dreamed of africa2000
68,2014-09-05,thunder and the house of magic,34000000,4091,62582520,2014,62578429,thunderandthehouseofmagic20140905,thunder and the house of magic2014
71,2000-06-02,big momma's house,33000000,117559438,173559438,2000,56000000,bigmommashouse20000602,big momma's house2000
72,2001-03-16,exit wounds,33000000,51758599,79958599,2001,28200000,exitwounds20010316,exit wounds2001
73,2016-07-08,mike and dave need wedding dates,33000000,46009673,75898100,2016,29888427,mikeanddaveneedweddingdates20160708,mike and dave need wedding dates2016
74,2012-07-27,step up revolution,33000000,35074677,165552290,2012,130477613,stepuprevolution20120727,step up revolution2012
75,2006-08-18,snakes on a plane,33000000,34020814,62020814,2006,28000000,snakesonaplane20060818,snakes on a plane2006
76,2004-04-16,the punisher,33000000,33664370,54533774,2004,20869404,thepunisher20040416,the punisher2004
77,2000-09-08,the watcher,33000000,28946615,47267829,2000,18321214,thewatcher20000908,the watcher2000
78,2012-04-27,safe,33000000,17142080,41495213,2012,24353133,safe20120427,safe2012
79,2008-03-14,doomsday,33000000,11008770,21621188,2008,10612418,doomsday20080314,doomsday2008
81,2006-05-12,goal! the dream begins,33000000,4283255,27610873,2006,23327618,goalthedreambegins20060512,goal! the dream begins2006
82,2015-07-31,the young and prodigious t.s. spivet,33000000,176847,357687,2015,180840,theyoungandprodigioustsspivet20150731,the young and prodigious t.s. spivet2015
83,2015-10-30,freaks of nature,33000000,70958,70958,2015,0,freaksofnature20151030,freaks of nature2015
85,2011-05-13,bridesmaids,32500000,169211718,289632023,2011,120420305,bridesmaids20110513,bridesmaids2011
86,2008-12-10,the reader,32500000,34194407,112964875,2008,78770468,thereader20081210,the reader2008
87,2013-04-26,the big wedding,32500000,21819348,48425971,2013,26606623,thebigwedding20130426,the big wedding2013
88,2012-02-24,wanderlust,32500000,17288155,24159934,2012,6871779,wanderlust20120224,wanderlust2012
89,2003-11-07,elf,32000000,173840591,220678483,2003,46837892,elf20031107,elf2003
91,2013-06-12,this is the end,32000000,101470202,126539117,2013,25068915,thisistheend20130612,this is the end2013
92,2002-01-18,snow dogs,32000000,81150692,116898028,2002,35747336,snowdogs20020118,snow dogs2002
93,2006-06-16,nacho libre,32000000,80197993,99296462,2006,19098469,nacholibre20060616,nacho libre2006
95,2010-08-27,takers,32000000,57744720,70587268,2010,12842548,takers20100827,takers2010
96,2011-04-01,source code,32000000,54712227,140428499,2011,85716272,sourcecode20110401,source code2011
98,2000-11-10,men of honor,32000000,48814909,82339483,2000,33524574,menofhonor20001110,men of honor2000
99,2018-04-20,i feel pretty,32000000,48795601,91553797,2018,42758196,ifeelpretty20180420,i feel pretty2018
100,2005-09-02,the transporter 2,32000000,43095856,88978458,2005,45882602,thetransporter220050902,the transporter 22005
1,2011-02-18,"big mommas: like father, like son",32000000,37915414,82332450,2011,44417036,bigmommaslikefatherlikeson20110218,"big mommas: like father, like son2011"
3,2007-02-23,the number 23,32000000,35193167,77593167,2007,42400000,thenumber2320070223,the number 232007
5,2005-10-21,dreamer: inspired by a true story,32000000,33022286,39498360,2005,6476074,dreamerinspiredbyatruestory20051021,dreamer: inspired by a true story2005
6,2005-09-23,a history of violence,32000000,31493782,61477797,2005,29984015,ahistoryofviolence20050923,a history of violence2005
7,2013-03-15,the incredible burt wonderstone,32000000,22537881,27392609,2013,4854728,theincredibleburtwonderstone20130315,the incredible burt wonderstone2013
9,2004-04-30,laws of attraction,32000000,17848322,29948322,2004,12100000,lawsofattraction20040430,laws of attraction2004
10,2018-10-12,bad times at the el royale,32000000,17839115,29204379,2018,11365264,badtimesattheelroyale20181012,bad times at the el royale2018
11,2010-09-03,going the distance,32000000,17804299,43603990,2010,25799691,goingthedistance20100903,going the distance2010
13,2010-03-19,repo men,32000000,13942007,18195238,2010,4253231,repomen20100319,repo men2010
14,2007-09-14,dragon wars: d-war,32000000,10977721,79915361,2007,68937640,dragonwarsdwar20070914,dragon wars: d-war2007
18,2006-12-15,the good german,32000000,1308696,6678033,2006,5369337,thegoodgerman20061215,the good german2006
19,2004-12-31,george and the dragon,32000000,0,0,2004,0,georgeandthedragon20041231,george and the dragon2004
21,2016-04-15,criminal,31500000,14708696,38771262,2016,24062566,criminal20160415,criminal2016
22,2013-04-12,42,31000000,95020213,97470701,2013,2450488,4220130412,422013
23,2012-11-02,flight,31000000,93772375,160558438,2012,66786063,flight20121102,flight2012
27,2014-03-07,the grand budapest hotel,31000000,59076019,163981261,2014,104905242,thegrandbudapesthotel20140307,the grand budapest hotel2014
28,2015-07-29,vacation,31000000,58884188,102306500,2015,43422312,vacation20150729,vacation2015
30,2019-02-13,isnât it romantic,31000000,48791187,48791187,2019,0,isnâtitromantic20190213,isnât it romantic2019
31,2000-04-28,frequency,31000000,44983704,68079671,2000,23095967,frequency20000428,frequency2000
32,2001-09-28,hearts in atlantis,31000000,24185781,30885781,2001,6700000,heartsinatlantis20010928,hearts in atlantis2001
33,2010-01-22,extraordinary measures,31000000,12482741,15826984,2010,3344243,extraordinarymeasures20100122,extraordinary measures2010
34,2017-08-25,birth of the dragon,31000000,6901965,7220490,2017,318525,birthofthedragon20170825,birth of the dragon2017
38,2018-08-15,crazy rich asians,30000000,174532921,238099711,2018,63566790,crazyrichasians20180815,crazy rich asians2018
39,2002-12-27,chicago,30000000,170687518,306770545,2002,136083027,chicago20021227,chicago2002
41,2001-08-10,american pie 2,30000000,145096820,286500000,2001,141403180,americanpie220010810,american pie 22001
42,2012-02-10,the vow,30000000,125014030,197618160,2012,72604130,thevow20120210,the vow2012
45,2013-08-16,lee daniels' the butler,30000000,116632095,177025498,2013,60393403,leedanielsthebutler20130816,lee daniels' the butler2013
46,2000-09-29,remember the titans,30000000,115654751,136706683,2000,21051932,rememberthetitans20000929,remember the titans2000
47,2009-08-14,district 9,30000000,115646235,212453431,2009,96807196,district920090814,district 92009
48,2004-06-18,dodgeball: a true underdog story,30000000,114326736,167791704,2004,53464968,dodgeballatrueunderdogstory20040618,dodgeball: a true underdog story2004
51,2001-08-03,the princess diaries,30000000,108244774,165334774,2001,57090000,theprincessdiaries20010803,the princess diaries2001
54,2004-12-15,million dollar baby,30000000,100492203,231928227,2004,131436024,milliondollarbaby20041215,million dollar baby2004
56,2003-10-08,mystic river,30000000,90135191,156822020,2003,66686829,mysticriver20031008,mystic river2003
57,2015-12-18,sisters,30000000,87044645,106030660,2015,18986015,sisters20151218,sisters2015
59,2004-11-19,spongebob squarepants: the movie,30000000,85416609,142051255,2004,56634646,spongebobsquarepantsthemovie20041119,spongebob squarepants: the movie2004
60,2009-12-04,up in the air,30000000,83823381,166842739,2009,83019358,upintheair20091204,up in the air2009
61,2004-06-25,the notebook,30000000,81001787,116025023,2004,35023236,thenotebook20040625,the notebook2004
62,2009-04-10,hannah montana the movie,30000000,79576189,169173206,2009,89597017,hannahmontanathemovie20090410,hannah montana the movie2009
63,2008-01-18,27 dresses,30000000,76808654,160247805,2008,83439151,27dresses20080118,27 dresses2008
64,2000-11-17,rugrats in paris,30000000,76501438,103284813,2000,26783375,rugratsinparis20001117,rugrats in paris2000
65,2017-08-18,the hitmanâs bodyguard,30000000,75468583,172778667,2017,97310084,thehitmanâsbodyguard20170818,the hitmanâs bodyguard2017
67,2005-08-12,four brothers,30000000,74494381,92494381,2005,18000000,fourbrothers20050812,four brothers2005
69,2012-09-28,looper,30000000,66486205,170466405,2012,103980200,looper20120928,looper2012
70,2013-02-01,warm bodies,30000000,66380662,115121608,2013,48740946,warmbodies20130201,warm bodies2013
71,2002-12-13,about schmidt,30000000,65005217,107054484,2002,42049267,aboutschmidt20021213,about schmidt2002
72,2014-01-17,the nut job,30000000,64251538,122529966,2014,58278428,thenutjob20140117,the nut job2014
73,2001-02-16,down to earth,30000000,64172251,71172251,2001,7000000,downtoearth20010216,down to earth2001
75,2012-08-08,hope springs,30000000,63536011,133085295,2012,69549284,hopesprings20120808,hope springs2012
76,2008-04-18,forgetting sarah marshall,30000000,63172463,105173042,2008,42000579,forgettingsarahmarshall20080418,forgetting sarah marshall2008
77,2004-10-08,friday night lights,30000000,61255921,61950770,2004,694849,fridaynightlights20041008,friday night lights2004
79,2008-04-25,baby mama,30000000,60494212,64170447,2008,3676235,babymama20080425,baby mama2008
81,2009-01-09,bride wars,30000000,58715510,115150424,2009,56434914,bridewars20090109,bride wars2009
82,2004-08-20,without a paddle,30000000,58156435,65121280,2004,6964845,withoutapaddle20040820,without a paddle2004
83,2011-05-20,midnight in paris,30000000,56816662,162502774,2011,105686112,midnightinparis20110520,midnight in paris2011
84,2017-11-22,darkest hour,30000000,56443120,150807172,2017,94364052,darkesthour20171122,darkest hour2017
85,2005-10-05,wallace & gromit: the curse of the were-rabbit,30000000,56068547,197593152,2005,141524605,wallacegromitthecurseofthewererabbit20051005,wallace & gromit: the curse of the were-rabbit2005
86,2007-12-21,p.s. i love you,30000000,53695808,155769678,2007,102073870,psiloveyou20071221,p.s. i love you2007
87,2005-09-23,corpse bride,30000000,53359111,114770654,2005,61411543,corpsebride20050923,corpse bride2005
88,2018-05-11,life of the party,30000000,53059911,65759911,2018,12700000,lifeoftheparty20180511,life of the party2018
89,2010-05-14,letters to juliet,30000000,53032453,82148538,2010,29116085,letterstojuliet20100514,letters to juliet2010
90,2001-04-06,blow,30000000,52990775,83282296,2001,30291521,blow20010406,blow2001
92,2015-07-24,southpaw,30000000,52421953,94156456,2015,41734503,southpaw20150724,southpaw2015
94,2017-07-28,atomic blonde,30000000,51573925,98345423,2017,46771498,atomicblonde20170728,atomic blonde2017
95,2002-07-03,like mike,30000000,51432423,62432423,2002,11000000,likemike20020703,like mike2002
97,2007-12-07,atonement,30000000,50980159,129779728,2007,78799569,atonement20071207,atonement2007
99,2005-01-14,racing stripes,30000000,49772522,89955540,2005,40183018,racingstripes20050114,racing stripes2005
100,2015-09-18,sicario,30000000,46889293,84393749,2015,37504456,sicario20150918,sicario2015
3,2018-01-19,den of thieves,30000000,44947622,80131391,2018,35183769,denofthieves20180119,den of thieves2018
4,2012-04-13,the three stooges,30000000,44338224,54052249,2012,9714025,thethreestooges20120413,the three stooges2012
5,2000-07-21,pokemon 2000,30000000,43746923,133946923,2000,90200000,pokemon200020000721,pokemon 20002000
6,2014-10-24,john wick,30000000,43037835,76235001,2014,33197166,johnwick20141024,john wick2014
7,2006-01-13,glory road,30000000,42647449,42799060,2006,151611,gloryroad20060113,glory road2006
8,2015-04-24,the age of adaline,30000000,42629776,68984536,2015,26354760,theageofadaline20150424,the age of adaline2015
9,2010-08-06,step up 3d,30000000,42400223,165889117,2010,123488894,stepup3d20100806,step up 3d2010
10,2009-05-29,drag me to hell,30000000,42100625,91388487,2009,49287862,dragmetohell20090529,drag me to hell2009
11,2012-04-13,the cabin in the woods,30000000,42073277,70689968,2012,28616691,thecabininthewoods20120413,the cabin in the woods2012
12,2003-09-19,secondhand lions,30000000,42070939,47902566,2003,5831627,secondhandlions20030919,secondhand lions2003
13,2006-11-10,stranger than fiction,30000000,40435190,53572822,2006,13137632,strangerthanfiction20061110,stranger than fiction2006
14,2011-04-08,hanna,30000000,40259119,65343694,2011,25084575,hanna20110408,hanna2011
15,2002-08-16,blue crush,30000000,40118420,51618420,2002,11500000,bluecrush20020816,blue crush2002
16,2007-10-19,30 days of night,30000000,39568996,80276156,2007,40707160,30daysofnight20071019,30 days of night2007
18,2006-09-15,gridiron gang,30000000,38432823,41457834,2006,3025011,gridirongang20060915,gridiron gang2006
20,2008-01-25,meet the spartans,30000000,38233676,84646831,2008,46413155,meetthespartans20080125,meet the spartans2008
22,2013-09-13,the family,30000000,36918811,51078541,2013,14159730,thefamily20130913,the family2013
23,2018-02-09,the 15:17 to paris,30000000,36276286,56096200,2018,19819914,the1517toparis20180209,the 15:17 to paris2018
25,2011-07-01,larry crowne,30000000,35608245,61449135,2011,25840890,larrycrowne20110701,larry crowne2011
26,2013-10-18,carrie,30000000,35266619,82409520,2013,47142901,carrie20131018,carrie2013
27,2006-04-07,take the lead,30000000,34742066,65390493,2006,30648427,takethelead20060407,take the lead2006
28,2018-03-02,death wish,30000000,34017028,48575965,2018,14558937,deathwish20180302,death wish2018
29,2010-11-24,love and other drugs,30000000,32367005,102716321,2010,70349316,loveandotherdrugs20101124,love and other drugs2010
30,2015-06-03,entourage,30000000,32363404,46438538,2015,14075134,entourage20150603,entourage2015
31,2001-06-01,what's the worst that could happen?,30000000,32267774,38462071,2001,6194297,whatstheworstthatcouldhappen20010601,what's the worst that could happen?2001
32,2013-02-08,side effects,30000000,32172757,66742138,2013,34569381,sideeffects20130208,side effects2013
33,2009-09-09,9,30000000,31749894,48559999,2009,16810105,920090909,92009
34,2014-07-02,deliver us from evil,30000000,30577122,87956618,2014,57379496,deliverusfromevil20140702,deliver us from evil2014
35,2014-08-01,get on up,30000000,30569935,33339868,2014,2769933,getonup20140801,get on up2014
36,2017-12-25,mollyâs game,30000000,28780744,53296424,2017,24515680,mollyâsgame20171225,mollyâs game2017
37,2012-04-27,the five-year engagement,30000000,28700285,61623819,2012,32923534,thefiveyearengagement20120427,the five-year engagement2012
38,2004-04-02,the prince & me,30000000,28165882,29356757,2004,1190875,theprinceme20040402,the prince & me2004
39,2011-07-15,winnie the pooh,30000000,26692846,50145607,2011,23452761,winniethepooh20110715,winnie the pooh2011
41,2003-06-13,dumb and dumberer: when harry met lloyd,30000000,26214846,26214846,2003,0,dumbanddumbererwhenharrymetlloyd20030613,dumb and dumberer: when harry met lloyd2003
42,2018-09-14,white boy rick,30000000,24004833,25947983,2018,1943150,whiteboyrick20180914,white boy rick2018
45,2011-02-04,sanctum,30000000,23209310,108957098,2011,85747788,sanctum20110204,sanctum2011
46,2006-07-21,my super ex-girlfriend,30000000,22530295,60772856,2006,38242561,mysuperexgirlfriend20060721,my super ex-girlfriend2006
47,2017-08-25,ballerina,30000000,21858070,96892829,2017,75034759,ballerina20170825,ballerina2017
48,2004-09-17,mr. 3000,30000000,21800302,21827296,2004,26994,mr300020040917,mr. 30002004
49,2010-11-19,the next three days,30000000,21148651,67255916,2010,46107265,thenextthreedays20101119,the next three days2010
50,2018-01-12,proud mary,30000000,20868638,21709539,2018,840901,proudmary20180112,proud mary2018
51,2004-08-06,little black book,30000000,20422207,21758371,2004,1336164,littleblackbook20040806,little black book2004
52,2005-01-19,assault on precinct 13,30000000,20040895,36040895,2005,16000000,assaultonprecinct1320050119,assault on precinct 132005
53,2013-10-04,runner runner,30000000,19316646,60512680,2013,41196034,runnerrunner20131004,runner runner2013
55,2017-04-28,baahubali 2: the conclusion,30000000,18985794,263502914,2017,244517120,baahubali2theconclusion20170428,baahubali 2: the conclusion2017
56,2006-03-03,ultraviolet,30000000,18522064,30962112,2006,12440048,ultraviolet20060303,ultraviolet2006
57,2005-10-21,north country,30000000,18324242,23676771,2005,5352529,northcountry20051021,north country2005
58,2011-08-19,fright night,30000000,18298649,40520649,2011,22222000,frightnight20110819,fright night2011
59,2017-09-15,mother!,30000000,17800004,42531076,2017,24731072,mother20170915,mother!2017
60,2015-10-09,steve jobs,30000000,17766658,35579007,2015,17812349,stevejobs20151009,steve jobs2015
61,2002-07-17,eight legged freaks,30000000,17266505,36722311,2002,19455806,eightleggedfreaks20020717,eight legged freaks2002
63,2010-06-04,splice,30000000,17010170,28542494,2010,11532324,splice20100604,splice2010
64,2008-04-18,88 minutes,30000000,16930884,32955399,2008,16024515,88minutes20080418,88 minutes2008
65,2004-04-09,the whole ten yards,30000000,16323969,26323969,2004,10000000,thewholetenyards20040409,the whole ten yards2004
67,2008-10-24,pride and glory,30000000,15740721,43440721,2008,27700000,prideandglory20081024,pride and glory2008
68,2005-08-26,the cave,30000000,15007991,27147991,2005,12140000,thecave20050826,the cave2005
69,2004-04-30,godsend,30000000,14334645,16910708,2004,2576063,godsend20040430,godsend2004
70,2003-06-20,alex & emma,30000000,14208384,15358583,2003,1150199,alexemma20030620,alex & emma2003
71,2004-09-03,wicker park,30000000,13001257,21577076,2004,8575819,wickerpark20040903,wicker park2004
72,2005-12-25,the new world,30000000,12712093,26184400,2005,13472307,thenewworld20051225,the new world2005
73,2007-06-29,evening,30000000,12406646,12885574,2007,478928,evening20070629,evening2007
74,2013-01-18,the last stand,30000000,12050299,48330757,2013,36280458,thelaststand20130118,the last stand2013
77,2001-01-12,antitrust,30000000,10965209,17865209,2001,6900000,antitrust20010112,antitrust2001
78,2013-03-08,dead man down,30000000,10895295,19599974,2013,8704679,deadmandown20130308,dead man down2013
79,2011-04-29,hoodwinked too: hood vs. evil,30000000,10143779,23353111,2011,13209332,hoodwinkedtoohoodvsevil20110429,hoodwinked too: hood vs. evil2011
80,2009-04-10,dragonball evolution,30000000,9362785,58228460,2009,48865675,dragonballevolution20090410,dragonball evolution2009
81,2004-09-24,first daughter,30000000,9055010,10419084,2004,1364074,firstdaughter20040924,first daughter2004
82,2017-04-14,the lost city of z,30000000,8574339,17121823,2017,8547484,thelostcityofz20170414,the lost city of z2017
83,2005-09-09,an unfinished life,30000000,8535575,18535575,2005,10000000,anunfinishedlife20050909,an unfinished life2005
84,2017-02-03,the space between us,30000000,7885294,16481405,2017,8596111,thespacebetweenus20170203,the space between us2017
85,2009-12-25,the imaginarium of doctor parnassus,30000000,7689607,64352607,2009,56663000,theimaginariumofdoctorparnassus20091225,the imaginarium of doctor parnassus2009
86,2011-01-14,barney's version,30000000,7502560,8845575,2011,1343015,barneysversion20110114,barney's version2011
87,2002-09-20,trapped,30000000,6916869,6916869,2002,0,trapped20020920,trapped2002
88,2018-08-31,kin,30000000,5718096,10096821,2018,4378725,kin20180831,kin2018
90,2017-09-22,stronger,30000000,4211129,8786752,2017,4575623,stronger20170922,stronger2017
92,2007-09-21,the assassination of jesse james by the coward robert ford,30000000,3909149,15313631,2007,11404482,theassassinationofjessejamesbythecowardrobertford20070921,the assassination of jesse james by the coward robert ford2007
93,2004-12-29,the merchant of venice,30000000,3765585,18765585,2004,15000000,themerchantofvenice20041229,the merchant of venice2004
94,2003-04-02,the good thief,30000000,3517797,6460758,2003,2942961,thegoodthief20030402,the good thief2003
95,2005-08-17,supercross,30000000,3102550,3252550,2005,150000,supercross20050817,supercross2005
96,2006-12-29,miss potter,30000000,3005605,35891257,2006,32885652,misspotter20061229,miss potter2006
97,2006-05-05,wu ji,30000000,669625,35869934,2006,35200309,wuji20060505,wu ji2006
98,2019-06-14,shaft,30000000,600000,600000,2019,0,shaft20190614,shaft2019
99,2011-09-23,machine gun preacher,30000000,538690,3721988,2011,3183298,machinegunpreacher20110923,machine gun preacher2011
100,2018-02-02,bilal: a new breed of hero,30000000,490973,648599,2018,157626,bilalanewbreedofhero20180202,bilal: a new breed of hero2018
1,2007-06-15,doa: dead or alive,30000000,480314,7755686,2007,7275372,doadeadoralive20070615,doa: dead or alive2007
2,2010-02-19,le petit nicolas,30000000,201857,52339566,2010,52137709,lepetitnicolas20100219,le petit nicolas2010
3,2011-10-07,xinhai geming,30000000,135739,8593154,2011,8457415,xinhaigeming20111007,xinhai geming2011
4,2008-02-21,genghis khan: to the ends of the earth and sea,30000000,3892,4874498,2008,4870606,genghiskhantotheendsoftheearthandsea20080221,genghis khan: to the ends of the earth and sea2008
5,2015-01-30,wild card,30000000,3200,4315789,2015,4312589,wildcard20150130,wild card2015
6,2015-06-05,united passions,30000000,918,168832,2015,167914,unitedpassions20150605,united passions2015
7,2010-12-31,konferenz der tiere,30000000,0,53048539,2010,53048539,konferenzdertiere20101231,konferenz der tiere2010
8,2015-12-01,grace of monaco,30000000,0,25199891,2015,25199891,graceofmonaco20151201,grace of monaco2015
9,2016-03-08,savva. serdtse voyna,30000000,0,5015080,2016,5015080,savvaserdtsevoyna20160308,savva. serdtse voyna2016
10,2007-12-14,goodbye bafana,30000000,0,2717302,2007,2717302,goodbyebafana20071214,goodbye bafana2007
11,2013-12-31,space pirate captain harlock,30000000,0,310985,2013,310985,spacepiratecaptainharlock20131231,space pirate captain harlock2013
12,2003-12-31,ripley's game,30000000,0,0,2003,0,ripleysgame20031231,ripley's game2003
13,2017-02-24,collide,29200000,2280004,5466698,2017,3186694,collide20170224,collide2017
14,2015-05-15,pitch perfect 2,29000000,184296230,287625468,2015,103329238,pitchperfect220150515,pitch perfect 22015
15,2005-11-18,walk the line,29000000,119519402,187707495,2005,68188093,walktheline20051118,walk the line2005
16,2018-09-28,night school,29000000,77339130,103008792,2018,25669662,nightschool20180928,night school2018
17,2016-04-08,the boss,29000000,63077560,78652207,2016,15574647,theboss20160408,the boss2016
19,2003-09-12,once upon a time in mexico,29000000,56330657,97413527,2003,41082870,onceuponatimeinmexico20030912,once upon a time in mexico2003
20,2000-04-14,keeping the faith,29000000,37036404,45336404,2000,8300000,keepingthefaith20000414,keeping the faith2000
21,2017-08-18,logan lucky,29000000,27778642,44264271,2017,16485629,loganlucky20170818,logan lucky2017
22,2016-08-12,florence foster jenkins,29000000,27383770,56000339,2016,28616569,florencefosterjenkins20160812,florence foster jenkins2016
24,2008-12-05,frost/nixon,29000000,18622031,28452945,2008,9830914,frostnixon20081205,frost/nixon2008
25,2004-11-12,seed of chucky,29000000,17016190,24716190,2004,7700000,seedofchucky20041112,seed of chucky2004
26,2002-08-23,serving sara,29000000,16930185,20146150,2002,3215965,servingsara20020823,serving sara2002
27,2002-12-31,confessions of a dangerous mind,29000000,16007718,33013805,2002,17006087,confessionsofadangerousmind20021231,confessions of a dangerous mind2002
28,2009-08-26,taking woodstock,29000000,7460204,10066366,2009,2606162,takingwoodstock20090826,taking woodstock2009
30,2019-09-30,unhinged,29000000,0,0,2019,0,unhinged20190930,unhinged2019
32,2005-03-04,the jacket,28500000,6301131,15452978,2005,9151847,thejacket20050304,the jacket2005
35,2015-08-14,straight outta compton,28000000,161197785,202182981,2015,40985196,straightouttacompton20150814,straight outta compton2015
36,2017-07-21,girls trip,28000000,115108515,140886353,2017,25777838,girlstrip20170721,girls trip2017
39,2001-04-06,along came a spider,28000000,74058698,105159085,2001,31100387,alongcameaspider20010406,along came a spider2001
40,2017-11-01,a bad moms christmas,28000000,72110659,127710550,2017,55599891,abadmomschristmas20171101,a bad moms christmas2017
41,2013-02-14,safe haven,28000000,71399120,94050951,2013,22651831,safehaven20130214,safe haven2013
42,2015-12-11,the big short,28000000,70259870,133162752,2015,62902882,thebigshort20151211,the big short2015
43,2008-11-07,role models,28000000,67300955,94500826,2008,27199871,rolemodels20081107,role models2008
44,2014-10-10,"alexander and the terrible, horrible, no good, very bad day",28000000,66954149,101379287,2014,34425138,alexanderandtheterriblehorriblenogoodverybadday20141010,"alexander and the terrible, horrible, no good, very bad day2014"
45,2004-02-06,miracle,28000000,64378093,64474705,2004,96612,miracle20040206,miracle2004
46,2013-01-28,last vegas,28000000,63914167,112914167,2013,49000000,lastvegas20130128,last vegas2013
47,2001-01-26,the wedding planner,28000000,60400856,94728529,2001,34327673,theweddingplanner20010126,the wedding planner2001
48,2004-03-19,dawn of the dead,28000000,58990765,103452875,2004,44462110,dawnofthedead20040319,dawn of the dead2004
50,2018-06-15,tag,28000000,54730625,77026186,2018,22295561,tag20180615,tag2018
51,2001-12-14,the royal tenenbaums,28000000,52353636,71430876,2001,19077240,theroyaltenenbaums20011214,the royal tenenbaums2001
52,2003-04-25,identity,28000000,52131264,82183683,2003,30052419,identity20030425,identity2003
53,2001-10-05,serendipity,28000000,50255310,77477297,2001,27221987,serendipity20011005,serendipity2001
54,2010-04-16,kick-ass,28000000,48071303,97531134,2010,49459831,kickass20100416,kick-ass2010
55,2001-09-28,zoolander,28000000,45172250,60780981,2001,15608731,zoolander20010928,zoolander2001
57,2007-07-27,no reservations,28000000,43107979,91943956,2007,48835977,noreservations20070727,no reservations2007
59,2005-11-11,pride & prejudice,28000000,38372662,126549607,2005,88176945,prideprejudice20051111,pride & prejudice2005
60,2011-08-12,30 minutes or less,28000000,37053924,40966716,2011,3912792,30minutesorless20110812,30 minutes or less2011
61,2000-12-22,dracula 2000,28000000,33000377,33000377,2000,0,dracula200020001222,dracula 20002000
64,2014-02-21,3 days to kill,28000000,30697999,38959900,2014,8261901,3daystokill20140221,3 days to kill2014
65,2013-08-16,kick-ass 2,28000000,28795985,63129909,2013,34333924,kickass220130816,kick-ass 22013
66,2007-10-12,we own the night,28000000,28563179,55307857,2007,26744678,weownthenight20071012,we own the night2007
67,2014-09-19,a walk among the tombstones,28000000,26017685,62108587,2014,36090902,awalkamongthetombstones20140919,a walk among the tombstones2014
68,2010-01-15,the spy next door,28000000,24307106,46752858,2010,22445752,thespynextdoor20100115,the spy next door2010
69,2014-04-25,brick mansions,28000000,20396829,73421224,2014,53024395,brickmansions20140425,brick mansions2014
70,2006-05-12,just my luck,28000000,17326650,38159905,2006,20833255,justmyluck20060512,just my luck2006
71,2000-10-13,lost souls,28000000,16779636,31320293,2000,14540657,lostsouls20001013,lost souls2000
72,2015-08-21,american ultra,28000000,14439985,30295028,2015,15855043,americanultra20150821,american ultra2015
73,2003-04-18,winged migration,28000000,11689053,39134983,2003,27445930,wingedmigration20030418,winged migration2003
74,2016-02-05,pride and prejudice and zombies,28000000,10907291,16638300,2016,5731009,prideandprejudiceandzombies20160205,pride and prejudice and zombies2016
76,2001-08-24,john carpenterâs ghosts of mars,28000000,8434601,8434601,2001,0,johncarpenterâsghostsofmars20010824,john carpenterâs ghosts of mars2001
78,2015-10-30,our brand is crisis,28000000,7002261,8594558,2015,1592297,ourbrandiscrisis20151030,our brand is crisis2015
80,2008-10-03,how to lose friends & alienate people,28000000,2775593,12031443,2008,9255850,howtolosefriendsalienatepeople20081003,how to lose friends & alienate people2008
81,2007-12-31,alatriste,28000000,0,22860477,2007,22860477,alatriste20071231,alatriste2007
82,2007-06-01,knocked up,27500000,148761765,219265952,2007,70504187,knockedup20070601,knocked up2007
84,2009-06-26,my sister's keeper,27500000,49200230,96673002,2009,47472772,mysisterskeeper20090626,my sister's keeper2009
85,2008-02-08,welcome home roscoe jenkins,27500000,42436517,43607627,2008,1171110,welcomehomeroscoejenkins20080208,welcome home roscoe jenkins2008
86,2012-01-13,joyful noise,27500000,30932113,31157914,2012,225801,joyfulnoise20120113,joyful noise2012
88,2006-12-25,notes on a scandal,27500000,17510118,50578411,2006,33068293,notesonascandal20061225,notes on a scandal2006
89,2007-10-19,rendition,27500000,9736045,26939925,2007,17203880,rendition20071019,rendition2007
90,2011-10-28,anonymous,27500000,4463292,15815509,2011,11352217,anonymous20111028,anonymous2011
91,2011-03-18,limitless,27000000,79249455,155564919,2011,76315464,limitless20110318,limitless2011
93,2002-06-07,the divine secrets of the ya-ya sisterhood,27000000,69586544,73826768,2002,4240224,thedivinesecretsoftheyayasisterhood20020607,the divine secrets of the ya-ya sisterhood2002
97,2008-08-06,the sisterhood of the traveling pants 2,27000000,44089964,44270131,2008,180167,thesisterhoodofthetravelingpants220080806,the sisterhood of the traveling pants 22008
98,2016-05-13,money monster,27000000,41012075,93466095,2016,52454020,moneymonster20160513,money monster2016
99,2002-05-17,about a boy,27000000,40803000,130759651,2002,89956651,aboutaboy20020517,about a boy2002
100,2011-08-19,spy kids: all the time in the world,27000000,38536376,80681183,2011,42144807,spykidsallthetimeintheworld20110819,spy kids: all the time in the world2011
2,2006-04-07,lucky number slevin,27000000,22495466,55495466,2006,33000000,luckynumberslevin20060407,lucky number slevin2006
6,2008-09-19,the duchess,27000000,13848978,45160110,2008,31311132,theduchess20080919,the duchess2008
7,2010-10-01,case 39,27000000,13261851,28773827,2010,15511976,case3920101001,case 392010
8,2005-06-10,the honeymooners,27000000,12834849,13174426,2005,339577,thehoneymooners20050610,the honeymooners2005
11,2004-08-27,suspect zero,27000000,8712564,8712564,2004,0,suspectzero20040827,suspect zero2004
12,2007-11-02,martian child,27000000,7500310,9352089,2007,1851779,martianchild20071102,martian child2007
13,2002-10-18,formula 51,27000000,5204007,5204007,2002,0,formula5120021018,formula 512002
15,2005-05-13,mindhunters,27000000,4476235,16566235,2005,12090000,mindhunters20050513,mindhunters2005
16,2008-10-17,what just happened,27000000,1090947,2412123,2008,1321176,whatjusthappened20081017,what just happened2008
17,2003-12-12,the statement,27000000,765637,1545064,2003,779427,thestatement20031212,the statement2003
18,2006-12-31,the magic flute,27000000,0,0,2006,0,themagicflute20061231,the magic flute2006
19,2016-11-23,rules donât apply,26700000,3652206,3871448,2016,219242,rulesdonâtapply20161123,rules donât apply2016
20,2009-01-16,paul blart: mall cop,26000000,146336178,185904750,2009,39568572,paulblartmallcop20090116,paul blart: mall cop2009
21,2003-08-06,freaky friday,26000000,110222438,160822438,2003,50600000,freakyfriday20030806,freaky friday2003
22,2005-08-19,the 40 year-old virgin,26000000,109449237,177344230,2005,67894993,the40yearoldvirgin20050819,the 40 year-old virgin2005
25,2008-08-06,pineapple express,26000000,87341380,102404019,2008,15062639,pineappleexpress20080806,pineapple express2008
29,2003-08-15,open range,26000000,58331254,68613992,2003,10282738,openrange20030815,open range2003
30,2005-08-19,red eye,26000000,57891803,96666486,2005,38774683,redeye20050819,red eye2005
31,2011-12-09,new yearâs eve,26000000,54544638,146850273,2011,92305635,newyearâseve20111209,new yearâs eve2011
33,2013-04-26,pain & gain,26000000,49875291,81275291,2013,31400000,paingain20130426,pain & gain2013
34,2003-01-31,final destination 2,26000000,46896664,90396664,2003,43500000,finaldestination220030131,final destination 22003
35,2000-12-22,"o brother, where art thou?",26000000,45506619,75763814,2000,30257195,obrotherwhereartthou20001222,"o brother, where art thou?2000"
36,2004-12-29,in good company,26000000,45489752,63489752,2004,18000000,ingoodcompany20041229,in good company2004
37,2010-01-22,legion,26000000,40168080,67647574,2010,27479494,legion20100122,legion2010
38,2012-08-29,lawless,26000000,37397291,54393687,2012,16996396,lawless20120829,lawless2012
39,2002-03-29,clockstoppers,26000000,36985501,38788828,2002,1803327,clockstoppers20020329,clockstoppers2002
41,2009-12-04,brothers,26000000,28544157,45043870,2009,16499713,brothers20091204,brothers2009
42,2014-10-17,the best of me,26000000,26766213,41059418,2014,14293205,thebestofme20141017,the best of me2014
43,2004-03-12,agent cody banks 2: destination london,26000000,23514247,28703083,2004,5188836,agentcodybanks2destinationlondon20040312,agent cody banks 2: destination london2004
44,2001-08-03,original sin,26000000,16521410,16521410,2001,0,originalsin20010803,original sin2001
45,2012-04-27,the raven,26000000,16008272,30601801,2012,14593529,theraven20120427,the raven2012
46,2004-02-20,welcome to mooseport,26000000,14469428,14469428,2004,0,welcometomooseport20040220,welcome to mooseport2004
48,2015-07-10,self/less,26000000,12279691,33667319,2015,21387628,selfless20150710,self/less2015
49,2001-08-24,the curse of the jade scorpion,26000000,7496522,18496522,2001,11000000,thecurseofthejadescorpion20010824,the curse of the jade scorpion2001
50,2013-10-18,the fifth estate,26000000,3254172,6154172,2013,2900000,thefifthestate20131018,the fifth estate2013
52,2014-03-21,blood ties,26000000,42472,2923959,2014,2881487,bloodties20140321,blood ties2014
54,2015-06-30,viy,26000000,0,34246770,2015,34246770,viy20150630,viy2015
55,2015-03-17,accidental love,26000000,0,135436,2015,135436,accidentallove20150317,accidental love2015
56,2015-04-24,the face of an angel,26000000,0,0,2015,0,thefaceofanangel20150424,the face of an angel2015
58,2005-08-31,the constant gardener,25500000,33579798,86301599,2005,52721801,theconstantgardener20050831,the constant gardener2005
59,2008-10-17,w.,25100000,25534493,28575778,2008,3041285,w20081017,w.2008
60,2004-02-25,the passion of the christ,25000000,370782930,622341924,2004,251558994,thepassionofthechrist20040225,the passion of the christ2004
63,2011-08-10,the help,25000000,169705587,213120004,2011,43414417,thehelp20110810,the help2011
64,2016-12-25,hidden figures,25000000,169607287,231771716,2016,62164429,hiddenfigures20161225,hidden figures2016
65,2008-12-12,gran torino,25000000,148095302,274543085,2008,126447783,grantorino20081212,gran torino2008
66,2009-01-30,taken,25000000,145000989,226941585,2009,81940596,taken20090130,taken2009
67,2014-01-17,ride along,25000000,134202565,153733800,2014,19531235,ridealong20140117,ride along2014
70,2003-07-02,"legally blonde 2: red, white & blonde",25000000,90639088,125339088,2003,34700000,legallyblonde2redwhiteblonde20030702,"legally blonde 2: red, white & blonde2003"
71,2004-03-26,scooby-doo 2: monsters unleashed,25000000,84185387,181185387,2004,97000000,scoobydoo2monstersunleashed20040326,scooby-doo 2: monsters unleashed2004
72,2004-07-09,anchorman: the legend of ron burgundy,25000000,84136909,89476265,2004,5339356,anchormanthelegendofronburgundy20040709,anchorman: the legend of ron burgundy2004
73,2003-08-15,freddy vs. jason,25000000,82622655,114576403,2003,31953748,freddyvsjason20030815,freddy vs. jason2003
74,2007-02-16,bridge to terabithia,25000000,82234139,137984788,2007,55750649,bridgetoterabithia20070216,bridge to terabithia2007
75,2001-12-21,jimmy neutron: boy genius,25000000,80936232,102992536,2001,22056304,jimmyneutronboygenius20011221,jimmy neutron: boy genius2001
76,2008-01-18,cloverfield,25000000,80048433,171302226,2008,91253793,cloverfield20080118,cloverfield2008
77,2010-02-05,dear john,25000000,80014842,142033509,2010,62018667,dearjohn20100205,dear john2010
79,2012-12-25,parental guidance,25000000,77267296,120832383,2012,43565087,parentalguidance20121225,parental guidance2012
81,2007-11-09,no country for old men,25000000,74273505,164035753,2007,89762248,nocountryforoldmen20071109,no country for old men2007
82,2001-04-13,bridget jones's diary,25000000,71500556,281527158,2001,210026602,bridgetjonessdiary20010413,bridget jones's diary2001
83,2000-12-15,chocolat,25000000,71309760,152500343,2000,81190583,chocolat20001215,chocolat2000
84,2011-01-21,no strings attached,25000000,70662220,149228078,2011,78565858,nostringsattached20110121,no strings attached2011
85,2012-01-13,contraband,25000000,66528000,98406855,2012,31878855,contraband20120113,contraband2012
86,2017-01-27,a dogâs purpose,25000000,64321890,203671625,2017,139349735,adogâspurpose20170127,a dogâs purpose2017
87,2012-04-20,the lucky one,25000000,60457138,96633833,2012,36176695,theluckyone20120420,the lucky one2012
89,2000-03-22,romeo must die,25000000,55973336,91036760,2000,35063424,romeomustdie20000322,romeo must die2000
90,2006-06-06,the omen,25000000,54607383,119295584,2006,64688201,theomen20060606,the omen2006
91,2006-02-10,final destination 3,25000000,54098051,112798051,2006,58700000,finaldestination320060210,final destination 32006
92,2011-04-22,madea's big happy family,25000000,53345287,54160818,2011,815531,madeasbighappyfamily20110422,madea's big happy family2011
93,2013-12-13,tyler perry's a madea christmas,25000000,52543354,52543354,2013,0,tylerperrysamadeachristmas20131213,tyler perry's a madea christmas2013
94,2004-11-12,finding neverland,25000000,51676606,115036108,2004,63359502,findingneverland20041112,finding neverland2004
95,2012-01-27,the grey,25000000,51580136,81249176,2012,29669040,thegrey20120127,the grey2012
96,2005-01-28,hide and seek,25000000,51100486,123696741,2005,72596255,hideandseek20050128,hide and seek2005
98,2008-08-22,the house bunny,25000000,48237389,71390601,2008,23153212,thehousebunny20080822,the house bunny2008
99,2003-03-14,agent cody banks,25000000,47545060,58240458,2003,10695398,agentcodybanks20030314,agent cody banks2003
100,2006-01-27,nanny mcphee,25000000,47279279,128745578,2006,81466299,nannymcphee20060127,nanny mcphee2006
2,2014-08-15,the giver,25000000,45090374,66540205,2014,21449831,thegiver20140815,the giver2014
6,2015-11-20,the night before,25000000,43035725,52427346,2015,9391621,thenightbefore20151120,the night before2015
8,2002-12-27,the hours,25000000,41675994,97030468,2002,55354474,thehours20021227,the hours2002
10,2007-12-26,there will be blood,25000000,40222514,77208711,2007,36986197,therewillbeblood20071226,there will be blood2007
11,2002-12-20,the wild thornberrys movie,25000000,40108697,60694737,2002,20586040,thewildthornberrysmovie20021220,the wild thornberrys movie2002
12,2003-06-13,rugrats go wild,25000000,39402572,55443032,2003,16040460,rugratsgowild20030613,rugrats go wild2003
13,2005-06-01,the sisterhood of the traveling pants,25000000,39053061,41560117,2005,2507056,thesisterhoodofthetravelingpants20050601,the sisterhood of the traveling pants2005
14,2002-05-31,undercover brother,25000000,38230435,40796145,2002,2565710,undercoverbrother20020531,undercover brother2002
15,2013-12-25,august: osage county,25000000,37738810,50738810,2013,13000000,augustosagecounty20131225,august: osage county2013
16,2001-07-06,kiss of the dragon,25000000,36833473,36833473,2001,0,kissofthedragon20010706,kiss of the dragon2001
17,2014-05-16,million dollar arm,25000000,36447959,39217912,2014,2769953,milliondollararm20140516,million dollar arm2014
18,2004-01-01,beauty shop,25000000,36351350,38351350,2004,2000000,beautyshop20040101,beauty shop2004
19,2003-04-04,what a girl wants,25000000,35990505,35990505,2003,0,whatagirlwants20030404,what a girl wants2003
20,2003-08-29,jeepers creepers ii,25000000,35623801,119923801,2003,84300000,jeeperscreepersii20030829,jeepers creepers ii2003
21,2018-09-07,peppermint,25000000,35418723,51800758,2018,16382035,peppermint20180907,peppermint2018
22,2007-09-21,good luck chuck,25000000,35017297,59183821,2007,24166524,goodluckchuck20070921,good luck chuck2007
23,2003-02-28,cradle 2 the grave,25000000,34657731,56434942,2003,21777211,cradle2thegrave20030228,cradle 2 the grave2003
24,2006-03-17,she's the man,25000000,33889159,55279608,2006,21390449,shestheman20060317,she's the man2006
25,2014-12-10,the gambler,25000000,33680992,38718031,2014,5037039,thegambler20141210,the gambler2014
26,2007-08-24,mr. beanâs holiday,25000000,33302167,234981342,2007,201679175,mrbeanâsholiday20070824,mr. beanâs holiday2007
27,2016-04-29,motherâs day,25000000,32492859,52367022,2016,19874163,motherâsday20160429,motherâs day2016
29,2017-02-17,fist fight,25000000,32187017,40286416,2017,8099399,fistfight20170217,fist fight2017
30,2007-11-21,august rush,25000000,31664162,65882103,2007,34217941,augustrush20071121,august rush2007
31,2004-08-27,anacondas: the hunt for the blood orchid,25000000,31526393,70326393,2004,38800000,anacondasthehuntforthebloodorchid20040827,anacondas: the hunt for the blood orchid2004
32,2011-12-09,the sitter,25000000,30542576,38749404,2011,8206828,thesitter20111209,the sitter2011
36,2014-04-11,draft day,25000000,28842237,29847480,2014,1005243,draftday20140411,draft day2014
38,2017-02-03,rings,25000000,27793018,82917283,2017,55124265,rings20170203,rings2017
39,2009-05-22,dance flick,25000000,25794018,32224624,2009,6430606,danceflick20090522,dance flick2009
40,2001-04-20,crocodile dundee in los angeles,25000000,25590119,39393111,2001,13802992,crocodiledundeeinlosangeles20010420,crocodile dundee in los angeles2001
42,2005-03-18,ice princess,25000000,24381334,25732334,2005,1351000,iceprincess20050318,ice princess2005
43,2011-08-26,don't be afraid of the dark,25000000,24046682,39126427,2011,15079745,dontbeafraidofthedark20110826,don't be afraid of the dark2011
44,2010-04-23,the losers,25000000,23591432,29863840,2010,6272408,thelosers20100423,the losers2010
45,2009-04-24,fighting,25000000,23091010,32831707,2009,9740697,fighting20090424,fighting2009
46,2007-08-24,war,25000000,22486409,40686409,2007,18200000,war20070824,war2007
48,2005-04-22,a lot like love,25000000,21835784,41921590,2005,20085806,alotlikelove20050422,a lot like love2005
50,2011-02-11,the eagle,25000000,19490041,38993548,2011,19503507,theeagle20110211,the eagle2011
51,2015-08-05,shaun the sheep,25000000,19375982,101925161,2015,82549179,shaunthesheep20150805,shaun the sheep2015
52,2011-09-02,shark night 3d,25000000,18877153,18877153,2011,0,sharknight3d20110902,shark night 3d2011
53,2017-03-24,chips,25000000,18600152,23190292,2017,4590140,chips20170324,chips2017
54,2002-10-11,punch-drunk love,25000000,17791031,24591031,2002,6800000,punchdrunklove20021011,punch-drunk love2002
55,2004-02-20,eurotrip,25000000,17718223,20718223,2004,3000000,eurotrip20040220,eurotrip2004
56,2017-12-22,father figures,25000000,17501244,21038441,2017,3537197,fatherfigures20171222,father figures2017
57,2008-04-04,the ruins,25000000,17432844,22910563,2008,5477719,theruins20080404,the ruins2008
58,2013-10-25,the counselor,25000000,16973715,71009334,2013,54035619,thecounselor20131025,the counselor2013
59,2006-12-08,unaccompanied minors,25000000,16655224,21970831,2006,5315607,unaccompaniedminors20061208,unaccompanied minors2006
60,2018-12-07,mary queen of scots,25000000,16468499,46734733,2018,30266234,maryqueenofscots20181207,mary queen of scots2018
62,2002-11-15,half past dead,25000000,15567860,19233280,2002,3665420,halfpastdead20021115,half past dead2002
65,2005-09-30,the greatest game ever played,25000000,15331289,15468266,2005,136977,thegreatestgameeverplayed20050930,the greatest game ever played2005
66,2009-11-06,the box,25000000,15051977,34356760,2009,19304783,thebox20091106,the box2009
67,2000-03-03,the next best thing,25000000,14983572,24355762,2000,9372190,thenextbestthing20000303,the next best thing2000
68,2010-10-08,my soul to take,25000000,14744435,16727470,2010,1983035,mysoultotake20101008,my soul to take2010
69,2004-04-09,the girl next door,25000000,14589444,31635150,2004,17045706,thegirlnextdoor20040409,the girl next door2004
70,2008-08-15,fly me to the moon,25000000,14543943,43530281,2008,28986338,flymetothemoon20080815,fly me to the moon2008
72,2002-09-13,stealing harvard,25000000,13973532,13973532,2002,0,stealingharvard20020913,stealing harvard2002
73,2007-08-03,hot rod,25000000,13938332,14334401,2007,396069,hotrod20070803,hot rod2007
74,2011-09-09,warrior,25000000,13657115,24215385,2011,10558270,warrior20110909,warrior2011
76,2017-09-22,battle of the sexes,25000000,12638526,18445379,2017,5806853,battleofthesexes20170922,battle of the sexes2017
77,2012-12-21,cirque du soleil: worlds away,25000000,12512862,28012862,2012,15500000,cirquedusoleilworldsaway20121221,cirque du soleil: worlds away2012
78,2015-11-13,the 33,25000000,12227722,28400715,2015,16172993,the3320151113,the 332015
80,2011-04-15,the conspirator,25000000,11538204,15907411,2011,4369207,theconspirator20110415,the conspirator2011
81,2002-07-03,the powerpuff girls,25000000,11411644,16425701,2002,5014057,thepowerpuffgirls20020703,the powerpuff girls2002
82,2005-06-03,the lords of dogtown,25000000,11273517,13424365,2005,2150848,thelordsofdogtown20050603,the lords of dogtown2005
85,2008-03-28,stop-loss,25000000,10915744,11229035,2008,313291,stoploss20080328,stop-loss2008
87,2002-10-18,abandon,25000000,10719367,12219367,2002,1500000,abandon20021018,abandon2002
88,2011-09-16,straw dogs,25000000,10324441,11253821,2011,929380,strawdogs20110916,straw dogs2011
90,2002-08-16,possession,25000000,10103647,14805812,2002,4702165,possession20020816,possession2002
93,2019-01-25,serenity,25000000,8547045,11367029,2019,2819984,serenity20190125,serenity2019
94,2009-11-25,the road,25000000,8114270,29206732,2009,21092462,theroad20091125,the road2009
95,2018-10-12,beautiful boy,25000000,7634767,13031424,2018,5396657,beautifulboy20181012,beautiful boy2018
96,2007-04-06,the hoax,25000000,7164995,7164995,2007,0,thehoax20070406,the hoax2007
97,2019-03-15,captive state,25000000,5958315,8993300,2019,3034985,captivestate20190315,captive state2019
99,2005-09-02,underclassman,25000000,5654777,5654777,2005,0,underclassman20050902,underclassman2005
100,2001-03-23,say it isn't so,25000000,5516708,5516708,2001,0,sayitisntso20010323,say it isn't so2001
1,2005-12-07,the world's fastest indian,25000000,5128124,18991288,2005,13863164,theworldsfastestindian20051207,the world's fastest indian2005
2,2008-04-25,deception,25000000,4598506,12850033,2008,8251527,deception20080425,deception2008
4,2005-04-22,king's ransom,25000000,4008527,4049527,2005,41000,kingsransom20050422,king's ransom2005
5,2008-10-03,blindness,25000000,3073392,20052958,2008,16979566,blindness20081003,blindness2008
6,2018-04-13,sgt. stubby: an american hero,25000000,3054285,3645957,2018,591672,sgtstubbyanamericanhero20180413,sgt. stubby: an american hero2018
7,2011-12-16,carnage,25000000,2546747,38112154,2011,35565407,carnage20111216,carnage2011
8,2017-09-01,tulip fever,25000000,2455635,6792768,2017,4337133,tulipfever20170901,tulip fever2017
9,2006-01-06,bloodrayne,25000000,2405420,3711633,2006,1306213,bloodrayne20060106,bloodrayne2006
10,2015-11-20,legend,25000000,1872994,42425450,2015,40552456,legend20151120,legend2015
11,2009-11-20,bad lieutenant: port of call new orleans,25000000,1702112,12413949,2009,10711837,badlieutenantportofcallneworleans20091120,bad lieutenant: port of call new orleans2009
12,2016-01-29,jane got a gun,25000000,1513793,3771345,2016,2257552,janegotagun20160129,jane got a gun2016
13,2009-11-25,me and orson welles,25000000,1190003,1190003,2009,0,meandorsonwelles20091125,me and orson welles2009
14,2005-09-16,venom,25000000,881745,881745,2005,0,venom20050916,venom2005
15,2005-10-14,where the truth lies,25000000,872142,1415656,2005,543514,wherethetruthlies20051014,where the truth lies2005
17,2013-03-22,on the road,25000000,720828,9313302,2013,8592474,ontheroad20130322,on the road2013
18,2012-08-24,les petits mouchoirs,25000000,205505,48530887,2012,48325382,lespetitsmouchoirs20120824,les petits mouchoirs2012
19,2010-06-30,love ranch,25000000,137885,146149,2010,8264,loveranch20100630,love ranch2010
20,2015-04-24,yi ge ren de wu lin,25000000,129115,129115,2015,0,yigerendewulin20150424,yi ge ren de wu lin2015
21,2010-12-31,sammy's avonturen: de geheime doorgang,25000000,0,71594792,2010,71594792,sammysavonturendegeheimedoorgang20101231,sammy's avonturen: de geheime doorgang2010
22,2010-12-31,belka i strelka. zvezdnye sobaki,25000000,0,9445081,2010,9445081,belkaistrelkazvezdnyesobaki20101231,belka i strelka. zvezdnye sobaki2010
23,2017-12-31,matilda,25000000,0,9370285,2017,9370285,matilda20171231,matilda2017
24,2011-10-04,la vã©ritable histoire du chat bottã©,25000000,0,8208594,2011,8208594,lavãritablehistoireduchatbottã20111004,la vã©ritable histoire du chat bottã©2011
25,2011-07-08,ironclad,25000000,0,5297411,2011,5297411,ironclad20110708,ironclad2011
26,2019-05-10,the professor and the madman,25000000,0,5227233,2019,5227233,theprofessorandthemadman20190510,the professor and the madman2019
27,2015-03-10,red sky,25000000,0,91116,2015,91116,redsky20150310,red sky2015
29,2014-01-10,the adventurer: the curse of the midas box,25000000,0,0,2014,0,theadventurerthecurseofthemidasbox20140110,the adventurer: the curse of the midas box2014
30,2019-12-31,reagan,25000000,0,0,2019,0,reagan20191231,reagan2019
31,2012-11-09,dangerous liaisons,24200000,17000,10447579,2012,10430579,dangerousliaisons20121109,dangerous liaisons2012
34,2003-02-21,old school,24000000,75155000,86765463,2003,11610463,oldschool20030221,old school2003
35,2006-12-20,rocky balboa,24000000,70269899,156229050,2006,85959151,rockybalboa20061220,rocky balboa2006
36,2014-06-20,think like a man too,24000000,65028687,70027933,2014,4999246,thinklikeamantoo20140620,think like a man too2014
37,2016-12-16,fences,24000000,57682904,64282881,2016,6599977,fences20161216,fences2016
38,2000-02-18,the whole nine yards,24000000,57262492,85527867,2000,28265375,thewholenineyards20000218,the whole nine yards2000
39,2011-10-14,footloose,24000000,51802742,62989834,2011,11187092,footloose20111014,footloose2011
40,2017-04-07,going in style,24000000,45018541,78672579,2017,33654038,goinginstyle20170407,going in style2017
44,2007-11-21,hitman,24000000,39687694,99135571,2007,59447877,hitman20071121,hitman2007
46,2000-04-07,return to me,24000000,32662299,32662299,2000,0,returntome20000407,return to me2000
47,2009-11-06,the men who stare at goats,24000000,32428195,67348218,2009,34920023,themenwhostareatgoats20091106,the men who stare at goats2009
48,2008-10-31,zack and miri make a porno,24000000,31457946,36856306,2008,5398360,zackandmirimakeaporno20081031,zack and miri make a porno2008
49,2001-01-12,double take,24000000,29823162,29823162,2001,0,doubletake20010112,double take2001
51,2000-09-08,nurse betty,24000000,25170054,27732366,2000,2562312,nursebetty20000908,nurse betty2000
52,2010-08-20,piranha 3d,24000000,25003155,83660160,2010,58657005,piranha3d20100820,piranha 3d2010
53,2010-11-24,faster,24000000,23240020,35792945,2010,12552925,faster20101124,faster2010
55,2004-01-23,win a date with tad hamilton!,24000000,16980098,16980098,2004,0,winadatewithtadhamilton20040123,win a date with tad hamilton!2004
57,2000-04-07,ready to rumble,24000000,12372410,12372410,2000,0,readytorumble20000407,ready to rumble2000
58,2011-09-16,i don't know how she does it,24000000,9659074,24474463,2011,14815389,idontknowhowshedoesit20110916,i don't know how she does it2011
60,2013-12-20,dhoom 3,24000000,8031955,11723620,2013,3691665,dhoom320131220,dhoom 32013
61,2004-12-17,beyond the sea,24000000,6144806,8292914,2004,2148108,beyondthesea20041217,beyond the sea2004
62,2005-06-10,hauru no ugoku shiro,24000000,4710455,237814327,2005,233103872,haurunougokushiro20050610,hauru no ugoku shiro2005
65,2005-06-10,the bridge of san luis rey,24000000,49981,1696765,2005,1646784,thebridgeofsanluisrey20050610,the bridge of san luis rey2005
66,2007-12-31,flood,24000000,0,4084232,2007,4084232,flood20071231,flood2007
67,2009-10-02,zombieland,23600000,75590286,102236596,2009,26646310,zombieland20091002,zombieland2009
71,2018-11-16,green book,23000000,85080171,322034439,2018,236954268,greenbook20181116,green book2018
73,2015-01-16,the wedding ringer,23000000,64460211,80171596,2015,15711385,theweddingringer20150116,the wedding ringer2015
74,2000-03-17,final destination,23000000,53302314,112036870,2000,58734556,finaldestination20000317,final destination2000
76,2011-10-07,the ides of march,23000000,40962534,77735925,2011,36773391,theidesofmarch20111007,the ides of march2011
77,2000-02-18,pitch black,23000000,39235088,53182088,2000,13947000,pitchblack20000218,pitch black2000
78,2018-10-05,the hate u give,23000000,29719483,35067665,2018,5348182,thehateugive20181005,the hate u give2018
79,2001-03-30,someone like you,23000000,27338033,38684906,2001,11346873,someonelikeyou20010330,someone like you2001
80,2014-01-10,her,23000000,25568251,48163815,2014,22595564,her20140110,her2014
81,2001-10-05,joy ride,23000000,21973182,21973182,2001,0,joyride20011005,joy ride2001
82,2012-02-17,kari gurashi no arietti,23000000,19192510,151496097,2012,132303587,karigurashinoarietti20120217,kari gurashi no arietti2012
83,2012-01-20,haywire,23000000,18942396,36374700,2012,17432304,haywire20120120,haywire2012
85,2004-09-01,vanity fair,23000000,16123851,19123851,2004,3000000,vanityfair20040901,vanity fair2004
86,2016-02-26,eddie the eagle,23000000,15789389,45060480,2016,29271091,eddietheeagle20160226,eddie the eagle2016
88,2000-08-25,the crew,23000000,13019253,13019253,2000,0,thecrew20000825,the crew2000
90,2004-01-09,chasing liberty,23000000,12189514,12291975,2004,102461,chasingliberty20040109,chasing liberty2004
91,2008-08-22,the longshots,23000000,11511323,11778396,2008,267073,thelongshots20080822,the longshots2008
94,2007-09-14,in the valley of elah,23000000,6777741,24489150,2007,17711409,inthevalleyofelah20070914,in the valley of elah2007
95,2009-09-25,coco avant chanel,23000000,6113834,50813834,2009,44700000,cocoavantchanel20090925,coco avant chanel2009
96,2009-06-26,chã©ri,23000000,2715657,2715657,2009,0,chãri20090626,chã©ri2009
97,2013-06-28,redemption,23000000,36686,13593473,2013,13556787,redemption20130628,redemption2013
98,2008-04-25,rogue,23000000,10452,4673377,2008,4662925,rogue20080425,rogue2008
99,2017-05-05,chäi dã n zhuänjiä,23000000,0,58807172,2017,58807172,chäidãnzhuänjiä20170505,chäi dã n zhuänjiä2017
100,2011-03-15,shi yue wei cheng,23000000,0,44195779,2011,44195779,shiyueweicheng20110315,shi yue wei cheng2011
2,2007-06-22,1408,22500000,71985628,131263370,2007,59277742,140820070622,14082007
3,2016-11-18,nocturnal animals,22500000,10663357,32398681,2016,21735324,nocturnalanimals20161118,nocturnal animals2016
4,2015-04-24,the water diviner,22500000,4200117,31054727,2015,26854610,thewaterdiviner20150424,the water diviner2015
8,2007-09-28,the game plan,22000000,90648202,146590987,2007,55942785,thegameplan20070928,the game plan2007
9,2002-03-29,the rookie,22000000,75600072,80491516,2002,4891444,therookie20020329,the rookie2002
11,2014-02-28,son of god,22000000,59700064,70949793,2014,11249729,sonofgod20140228,son of god2014
12,2001-06-01,the animal,22000000,55762229,55762229,2001,0,theanimal20010601,the animal2001
13,2014-08-08,the hundred-foot journey,22000000,54235441,94270488,2014,40035047,thehundredfootjourney20140808,the hundred-foot journey2014
15,2003-09-19,underworld,22000000,51970690,95708457,2003,43737767,underworld20030919,underworld2003
17,2012-08-03,diary of a wimpy kid: dog days,22000000,49008662,77229695,2012,28221033,diaryofawimpykiddogdays20120803,diary of a wimpy kid: dog days2012
18,2001-12-28,i am sam,22000000,40270895,92542418,2001,52271523,iamsam20011228,i am sam2001
19,2005-11-11,derailed,22000000,36020063,57520063,2005,21500000,derailed20051111,derailed2005
20,2009-09-18,the informant!,22000000,33316821,41771168,2009,8454347,theinformant20090918,the informant!2009
21,2013-11-22,delivery man,22000000,30659817,70536870,2013,39877053,deliveryman20131122,delivery man2013
22,2016-02-05,"hail, caesar!",22000000,30080225,64160680,2016,34080455,hailcaesar20160205,"hail, caesar!2016"
23,2001-08-24,jay and silent bob strike back,22000000,30059386,33762400,2001,3703014,jayandsilentbobstrikeback20010824,jay and silent bob strike back2001
25,2008-08-27,traitor,22000000,23530831,27882226,2008,4351395,traitor20080827,traitor2008
26,2005-08-12,deuce bigalow: european gigolo,22000000,22400154,45273464,2005,22873310,deucebigaloweuropeangigolo20050812,deuce bigalow: european gigolo2005
27,2017-05-19,diary of a wimpy kid: the long haul,22000000,20738724,35609577,2017,14870853,diaryofawimpykidthelonghaul20170519,diary of a wimpy kid: the long haul2017
28,2008-01-18,mad money,22000000,20668843,25044057,2008,4375214,madmoney20080118,mad money2008
29,2013-11-27,homefront,22000000,20158492,51695362,2013,31536870,homefront20131127,homefront2013
30,2008-09-19,igor,22000000,19528602,31013349,2008,11484747,igor20080919,igor2008
31,2001-02-09,saving silverman,22000000,19351569,25873142,2001,6521573,savingsilverman20010209,saving silverman2001
33,2001-09-14,the glass house,22000000,17951431,22861785,2001,4910354,theglasshouse20010914,the glass house2001
34,2015-09-04,the transporter refueled,22000000,16029670,69698495,2015,53668825,thetransporterrefueled20150904,the transporter refueled2015
36,2001-04-11,josie and the pussycats,22000000,14252830,14252830,2001,0,josieandthepussycats20010411,josie and the pussycats2001
37,2012-08-22,hit & run,22000000,13749300,17216955,2012,3467655,hitrun20120822,hit & run2012
38,2000-10-27,the little vampire,22000000,13555988,13555988,2000,0,thelittlevampire20001027,the little vampire2000
39,2004-10-01,i heart huckabees,22000000,12784713,20034713,2004,7250000,ihearthuckabees20041001,i heart huckabees2004
40,2017-11-17,"roman j. israel, esq.",22000000,11962712,12967012,2017,1004300,romanjisraelesq20171117,"roman j. israel, esq.2017"
41,2013-12-04,out of the furnace,22000000,11330849,15434375,2013,4103526,outofthefurnace20131204,out of the furnace2013
44,2017-12-08,just getting started,22000000,6069605,6756412,2017,686807,justgettingstarted20171208,just getting started2017
45,2001-09-21,megiddo: omega code 2,22000000,6047691,6047691,2001,0,megiddoomegacode220010921,megiddo: omega code 22001
47,2005-11-23,the libertine,22000000,4835065,9448623,2005,4613558,thelibertine20051123,the libertine2005
48,2007-04-06,zwartboek,22000000,4398532,27238354,2007,22839822,zwartboek20070406,zwartboek2007
49,2014-10-31,before i go to sleep,22000000,3242457,19563579,2014,16321122,beforeigotosleep20141031,before i go to sleep2014
50,2010-10-08,stone,22000000,1810078,4065020,2010,2254942,stone20101008,stone2010
51,2006-03-03,joyeux noã«l,22000000,1054361,23134075,2006,22079714,joyeuxnoãl20060303,joyeux noã«l2006
52,2013-12-31,metegol,22000000,0,34061097,2013,34061097,metegol20131231,metegol2013
54,2007-07-27,moliã¨re,21600000,635733,791154,2007,155421,moliãre20070727,moliã¨re2007
55,2007-10-05,michael clayton,21500000,49033882,92987651,2007,43953769,michaelclayton20071005,michael clayton2007
58,2012-06-22,to rome with love,21500000,16684352,74326015,2012,57641663,toromewithlove20120622,to rome with love2012
59,2012-11-16,silver linings playbook,21000000,132092958,236412453,2012,104319495,silverliningsplaybook20121116,silver linings playbook2012
60,2018-04-06,blockers,21000000,60311495,94045328,2018,33733833,blockers20180406,blockers2018
61,2019-04-05,pet sematary,21000000,54724696,109501146,2019,54776450,petsematary20190405,pet sematary2019
64,2010-04-16,death at a funeral,21000000,42739347,48977233,2010,6237886,deathatafuneral20100416,death at a funeral2010
66,2001-09-14,hardball,21000000,40222729,43728560,2001,3505831,hardball20010914,hardball2001
67,2010-11-05,for colored girls,21000000,37729698,38017873,2010,288175,forcoloredgirls20101105,for colored girls2010
68,2007-01-05,freedom writers,21000000,36605602,43632609,2007,7027007,freedomwriters20070105,freedom writers2007
69,2017-08-04,kidnap,21000000,30718107,34836080,2017,4117973,kidnap20170804,kidnap2017
70,2002-10-11,the transporter,21000000,25296447,43928932,2002,18632485,thetransporter20021011,the transporter2002
71,2008-03-14,never back down,21000000,24850922,39319801,2008,14468879,neverbackdown20080314,never back down2008
72,2011-12-09,tinker tailor soldier spy,21000000,24149393,81452811,2011,57303418,tinkertailorsoldierspy20111209,tinker tailor soldier spy2011
73,2017-09-22,victoria and abdul,21000000,22245070,68271146,2017,46026076,victoriaandabdul20170922,victoria and abdul2017
76,2008-08-01,swing vote,21000000,16289867,17589867,2008,1300000,swingvote20080801,swing vote2008
77,2009-06-05,away we go,21000000,9451946,10108016,2009,656070,awaywego20090605,away we go2009
78,2002-09-27,moonlight mile,21000000,6830957,6830957,2002,0,moonlightmile20020927,moonlight mile2002
79,2011-05-06,the beaver,21000000,970816,5046038,2011,4075222,thebeaver20110506,the beaver2011
80,2017-02-24,bitter harvest,21000000,557241,606162,2017,48921,bitterharvest20170224,bitter harvest2017
82,2019-02-01,velvet buzzsaw,21000000,0,0,2019,0,velvetbuzzsaw20190201,velvet buzzsaw2019
85,2006-08-11,pulse,20500000,20264436,30241435,2006,9976999,pulse20060811,pulse2006
88,2019-03-22,us,20000000,175006930,254210310,2019,79203380,us20190322,us2019
92,2016-12-09,la la land,20000000,151101803,426351163,2016,275249360,lalaland20161209,la la land2016
93,2013-07-19,the conjuring,20000000,137400141,318000141,2013,180600000,theconjuring20130719,the conjuring2013
94,2003-03-07,bringing down the house,20000000,132675402,164675402,2003,32000000,bringingdownthehouse20030307,bringing down the house2003
95,2017-11-17,wonder,20000000,132422809,304604712,2017,172181903,wonder20171117,wonder2017
98,2010-10-15,jackass 3d,20000000,117229692,171685793,2010,54456101,jackass3d20101015,jackass 3d2010
99,2016-07-29,bad moms,20000000,113257297,180998716,2016,67741419,badmoms20160729,bad moms2016
100,2019-01-18,glass,20000000,111035005,245303505,2019,134268500,glass20190118,glass2019
2,2008-10-03,beverly hills chihuahua,20000000,94514402,154218168,2008,59703766,beverlyhillschihuahua20081003,beverly hills chihuahua2008
3,2014-07-02,tammy,20000000,84525432,96407655,2014,11882223,tammy20140702,tammy2014
4,2005-01-21,are we there yet?,20000000,82674398,98114471,2005,15440073,arewethereyet20050121,are we there yet?2005
5,2011-11-16,the descendants,20000000,82624961,175507800,2011,92882839,thedescendants20111116,the descendants2011
6,2003-10-03,school of rock,20000000,81261177,131944672,2003,50683495,schoolofrock20031003,school of rock2003
7,2007-04-13,disturbia,20000000,80818974,118537627,2007,37718653,disturbia20070413,disturbia2007
9,2016-10-21,tyler perryâs boo! a madea halloween,20000000,73206343,73206343,2016,0,tylerperryâsbooamadeahalloween20161021,tyler perryâs boo! a madea halloween2016
11,2004-06-23,white chicks,20000000,69148997,111448997,2004,42300000,whitechicks20040623,white chicks2004
12,2009-04-24,obsessed,20000000,68261644,73964713,2009,5703069,obsessed20090424,obsessed2009
13,2003-04-18,holes,20000000,67383924,71232214,2003,3848290,holes20030418,holes2003
14,2012-06-29,tyler perry's madea's witness protection,20000000,65653242,66950887,2012,1297645,tylerperrysmadeaswitnessprotection20120629,tyler perry's madea's witness protection2012
15,2010-03-31,the last song,20000000,62950384,92678948,2010,29728564,thelastsong20100331,the last song2010
16,2010-04-02,why did i get married too?,20000000,60095852,60831067,2010,735215,whydidigetmarriedtoo20100402,why did i get married too?2010
18,2013-10-18,12 years a slave,20000000,56671993,181025343,2013,124353350,12yearsaslave20131018,12 years a slave2013
19,2002-12-13,drumline,20000000,56398162,56398162,2002,0,drumline20021213,drumline2002
20,2016-06-03,me before you,20000000,56245075,208265198,2016,152020123,mebeforeyou20160603,me before you2016
21,2019-02-08,what men want,20000000,54611903,69911903,2019,15300000,whatmenwant20190208,what men want2019
22,2016-04-15,barbershop: the next cut,20000000,54030051,54404202,2016,374151,barbershopthenextcut20160415,barbershop: the next cut2016
24,2018-09-14,a simple favor,20000000,53548586,97628717,2018,44080131,asimplefavor20180914,a simple favor2018
25,2015-01-09,selma,20000000,52076908,66776576,2015,14699668,selma20150109,selma2015
27,2006-02-17,date movie,20000000,48548426,85146165,2006,36597739,datemovie20060217,date movie2006
28,2002-02-15,peter pan: return to neverland,20000000,48430258,109862682,2002,61432424,peterpanreturntoneverland20020215,peter pan: return to neverland2002
29,2003-02-14,the jungle book 2,20000000,47901582,140122225,2003,92220643,thejunglebook220030214,the jungle book 22003
30,2007-03-16,premonition,20000000,47852604,81461343,2007,33608739,premonition20070316,premonition2007
31,2017-10-20,tyler perryâs boo 2! a madea halloween,20000000,47319572,47879572,2017,560000,tylerperryâsboo2amadeahalloween20171020,tyler perryâs boo 2! a madea halloween2017
32,2005-02-04,boogeyman,20000000,46752382,67192859,2005,20440477,boogeyman20050204,boogeyman2005
33,2000-02-11,the tigger movie,20000000,45542421,96147688,2000,50605267,thetiggermovie20000211,the tigger movie2000
34,2015-11-06,spotlight,20000000,45055776,92088460,2015,47032684,spotlight20151106,spotlight2015
35,2018-03-30,acrimony,20000000,43549096,46627836,2018,3078740,acrimony20180330,acrimony2018
36,2015-06-26,max,20000000,42656255,43658157,2015,1001902,max20150626,max2015
37,2008-03-21,meet the browns,20000000,41975388,41975388,2008,0,meetthebrowns20080321,meet the browns2008
38,2009-07-24,orphan,20000000,41596251,78769428,2009,37173177,orphan20090724,orphan2009
39,2017-11-17,the star,20000000,40847995,62758010,2017,21910015,thestar20171117,the star2017
40,2007-01-26,epic movie,20000000,39739367,86858578,2007,47119211,epicmovie20070126,epic movie2007
41,2008-09-19,lakeview terrace,20000000,39263506,44821299,2008,5557793,lakeviewterrace20080919,lakeview terrace2008
42,2006-10-13,the grudge 2,20000000,39143839,70743839,2006,31600000,thegrudge220061013,the grudge 22006
43,2016-07-27,nerve,20000000,38583626,70652284,2016,32068658,nerve20160727,nerve2016
47,2006-10-13,man of the year,20000000,37442180,41342180,2006,3900000,manoftheyear20061013,man of the year2006
48,2016-02-19,risen,20000000,36880033,46255763,2016,9375730,risen20160219,risen2016
49,2010-08-18,vampires suck,20000000,36661504,81424988,2010,44763484,vampiressuck20100818,vampires suck2010
51,2010-09-01,the american,20000000,35606376,67950723,2010,32344347,theamerican20100901,the american2010
53,2011-11-04,a very harold & kumar 3d christmas,20000000,35061031,36265745,2011,1204714,averyharoldkumar3dchristmas20111104,a very harold & kumar 3d christmas2011
54,2004-03-19,eternal sunshine of the spotless mind,20000000,34366518,72570762,2004,38204244,eternalsunshineofthespotlessmind20040319,eternal sunshine of the spotless mind2004
55,2013-01-04,texas chainsaw 3d,20000000,34341945,47666013,2013,13324068,texaschainsaw3d20130104,texas chainsaw 3d2013
56,2006-10-27,babel,20000000,34302837,132121212,2006,97818375,babel20061027,babel2006
57,2014-09-19,this is where i leave you,20000000,34296320,41296320,2014,7000000,thisiswhereileaveyou20140919,this is where i leave you2014
58,2008-12-12,doubt,20000000,33446470,53191101,2008,19744631,doubt20081212,doubt2008
59,2004-10-15,team america: world police,20000000,32774834,50948811,2004,18173977,teamamericaworldpolice20041015,team america: world police2004
61,2013-04-12,scary movie v,20000000,32015787,78613981,2013,46598194,scarymoviev20130412,scary movie v2013
62,2010-03-12,she's out of my league,20000000,32010860,48680977,2010,16670117,shesoutofmyleague20100312,she's out of my league2010
63,2008-11-26,milk,20000000,31841299,57293371,2008,25452072,milk20081126,milk2008
65,2011-08-31,the debt,20000000,31177548,46604054,2011,15426506,thedebt20110831,the debt2011
66,2002-10-25,ghost ship,20000000,30113491,68349884,2002,38236393,ghostship20021025,ghost ship2002
67,2010-01-08,daybreakers,20000000,30101577,51445503,2010,21343926,daybreakers20100108,daybreakers2010
68,2008-03-07,the bank job,20000000,30060660,66143005,2008,36082345,thebankjob20080307,the bank job2008
70,2009-10-16,the stepfather,20000000,29062561,29227561,2009,165000,thestepfather20091016,the stepfather2009
71,2000-03-31,high fidelity,20000000,27277055,47881663,2000,20604608,highfidelity20000331,high fidelity2000
72,2006-04-28,stick it,20000000,26910736,30399714,2006,3488978,stickit20060428,stick it2006
73,2008-01-04,one missed call,20000000,26890041,44513466,2008,17623425,onemissedcall20080104,one missed call2008
75,2008-04-11,street kings,20000000,26418667,65457811,2008,39039144,streetkings20080411,street kings2008
76,2013-08-23,the world's end,20000000,26004851,47508505,2013,21503654,theworldsend20130823,the world's end2013
78,2010-09-24,you again,20000000,25702053,32838945,2010,7136892,youagain20100924,you again2010
79,2007-06-15,nancy drew,20000000,25584685,30703845,2007,5119160,nancydrew20070615,nancy drew2007
80,2010-09-17,alpha and omega 3d,20000000,25107267,48958353,2010,23851086,alphaandomega3d20100917,alpha and omega 3d2010
81,2018-12-25,on the basis of sex,20000000,24622687,38073377,2018,13450690,onthebasisofsex20181225,on the basis of sex2018
82,2014-02-14,endless love,20000000,23438250,34718173,2014,11279923,endlesslove20140214,endless love2014
83,2006-09-08,the covenant,20000000,23364784,38164784,2006,14800000,thecovenant20060908,the covenant2006
84,2011-07-01,monte carlo,20000000,23186769,39686769,2011,16500000,montecarlo20110701,monte carlo2011
85,2006-03-24,stay alive,20000000,23086480,23187506,2006,101026,stayalive20060324,stay alive2006
86,2005-10-07,2 for the money,20000000,22991379,30491379,2005,7500000,2forthemoney20051007,2 for the money2005
87,2017-06-16,rough night,20000000,22105643,46844357,2017,24738714,roughnight20170616,rough night2017
91,2009-08-21,shorts,20000000,20919166,29870801,2009,8951635,shorts20090821,shorts2009
93,2008-09-19,appaloosa,20000000,20211394,27911453,2008,7700059,appaloosa20080919,appaloosa2008
94,2015-11-20,secret in their eyes,20000000,20180155,32608019,2015,12427864,secretintheireyes20151120,secret in their eyes2015
95,2004-08-13,yu-gi-oh,20000000,19762690,28762690,2004,9000000,yugioh20040813,yu-gi-oh2004
96,2007-03-23,reign over me,20000000,19661987,20081987,2007,420000,reignoverme20070323,reign over me2007
97,2008-09-19,my best friend's girl,20000000,19219250,34787111,2008,15567861,mybestfriendsgirl20080919,my best friend's girl2008
98,2007-05-11,georgia rule,20000000,18882880,20819601,2007,1936721,georgiarule20070511,georgia rule2007
1,2007-09-21,into the wild,20000000,18354356,56822960,2007,38468604,intothewild20070921,into the wild2007
3,2005-02-11,pooh's heffalump movie,20000000,18098433,55686944,2005,37588511,poohsheffalumpmovie20050211,pooh's heffalump movie2005
4,2006-09-29,school for scoundrels,20000000,17807569,17807569,2006,0,schoolforscoundrels20060929,school for scoundrels2006
5,2012-10-26,silent hill: revelation 3d,20000000,17530219,55975672,2012,38445453,silenthillrevelation3d20121026,silent hill: revelation 3d2012
7,2017-03-31,the zookeeperâs wife,20000000,17445186,26308749,2017,8863563,thezookeeperâswife20170331,the zookeeperâs wife2017
8,2009-02-20,fired up,20000000,17231291,18608570,2009,1377279,firedup20090220,fired up2009
9,2005-04-08,kung fu hustle,20000000,17104669,102034104,2005,84929435,kungfuhustle20050408,kung fu hustle2005
10,2002-07-26,the country bears,20000000,16988996,16988996,2002,0,thecountrybears20020726,the country bears2002
11,2017-09-29,flatliners,20000000,16883115,45173738,2017,28290623,flatliners20170929,flatliners2017
12,2007-03-16,dead silence,20000000,16574590,20614661,2007,4040071,deadsilence20070316,dead silence2007
13,2003-11-21,21 grams,20000000,16248701,59667625,2003,43418924,21grams20031121,21 grams2003
14,2009-12-04,armored,20000000,15988876,23661038,2009,7672162,armored20091204,armored2009
15,2007-12-14,the kite runner,20000000,15800078,74180745,2007,58380667,thekiterunner20071214,the kite runner2007
16,2004-09-03,paparazzi,20000000,15712072,16612072,2004,900000,paparazzi20040903,paparazzi2004
17,2003-01-17,a guy thing,20000000,15543862,17430594,2003,1886732,aguything20030117,a guy thing2003
19,2000-07-21,loser,20000000,15464026,18250106,2000,2786080,loser20000721,loser2000
21,2009-09-23,capitalism: a love story,20000000,14363397,19121531,2009,4758134,capitalismalovestory20090923,capitalism: a love story2009
22,2012-04-13,lockout,20000000,14326865,33943049,2012,19616184,lockout20120413,lockout2012
23,2008-08-29,disaster movie,20000000,14190901,36720752,2008,22529851,disastermovie20080829,disaster movie2008
24,2011-09-30,what's your number?,20000000,14011084,30163785,2011,16152701,whatsyournumber20110930,what's your number?2011
26,2009-04-17,crank 2: high voltage,20000000,13684249,35472739,2009,21788490,crank2highvoltage20090417,crank 2: high voltage2009
27,2015-10-30,burnt,20000000,13651946,36773510,2015,23121564,burnt20151030,burnt2015
28,2004-04-30,envy,20000000,13548322,14566246,2004,1017924,envy20040430,envy2004
29,2006-10-13,one night with the king,20000000,13395961,13725032,2006,329071,onenightwiththeking20061013,one night with the king2006
31,2008-09-19,ghost town,20000000,13367624,29958228,2008,16590604,ghosttown20080919,ghost town2008
32,2002-11-22,the quiet american,20000000,12987647,26348203,2002,13360556,thequietamerican20021122,the quiet american2002
33,2016-02-26,triple 9,20000000,12639297,25943792,2016,13304495,triple920160226,triple 92016
34,2016-09-02,the light between oceans,20000000,12545979,22281732,2016,9735753,thelightbetweenoceans20160902,the light between oceans2016
35,2005-10-28,the weather man,20000000,12482775,15466961,2005,2984186,theweatherman20051028,the weather man2005
36,2002-08-23,undisputed,20000000,12398628,12398628,2002,0,undisputed20020823,undisputed2002
37,2009-03-27,12 rounds,20000000,12234694,17306648,2009,5071954,12rounds20090327,12 rounds2009
38,2010-10-01,let me in,20000000,12134935,28270399,2010,16135464,letmein20101001,let me in2010
40,2008-02-22,be kind rewind,20000000,11175164,30894247,2008,19719083,bekindrewind20080222,be kind rewind2008
41,2005-12-09,mrs. henderson presents,20000000,11036366,27836366,2005,16800000,mrshendersonpresents20051209,mrs. henderson presents2005
46,2007-08-31,death sentence,20000000,9534258,16907831,2007,7373573,deathsentence20070831,death sentence2007
47,2016-06-03,popstar: never stop never stopping,20000000,9496130,9537120,2016,40990,popstarneverstopneverstopping20160603,popstar: never stop never stopping2016
48,2017-10-27,thank you for your service,20000000,9479390,9985316,2017,505926,thankyouforyourservice20171027,thank you for your service2017
49,2009-12-04,everybody's fine,20000000,9208876,9208876,2009,0,everybodysfine20091204,everybody's fine2009
50,2004-08-27,superbabies: baby geniuses 2,20000000,9109322,9355369,2004,246047,superbabiesbabygeniuses220040827,superbabies: baby geniuses 22004
51,2013-09-20,battle of the year,20000000,8888355,16723377,2013,7835022,battleoftheyear20130920,battle of the year2013
52,2016-04-29,ratchet and clank,20000000,8813410,14365639,2016,5552229,ratchetandclank20160429,ratchet and clank2016
53,2007-08-17,death at a funeral,20000000,8580428,46790428,2007,38210000,deathatafuneral20070817,death at a funeral2007
54,2005-09-09,the man,20000000,8330720,10393696,2005,2062976,theman20050909,the man2005
55,2007-01-05,code name: the cleaner,20000000,8135024,8135024,2007,0,codenamethecleaner20070105,code name: the cleaner2007
56,2014-12-12,inherent vice,20000000,8110975,14772346,2014,6661371,inherentvice20141212,inherent vice2014
57,2004-04-16,connie & carla,20000000,8047525,8047525,2004,0,conniecarla20040416,connie & carla2004
58,2013-10-11,machete kills,20000000,8008161,18273009,2013,10264848,machetekills20131011,machete kills2013
60,2006-02-24,doogal,20000000,7578946,28058652,2006,20479706,doogal20060224,doogal2006
61,2005-09-16,proof,20000000,7535331,8284331,2005,749000,proof20050916,proof2005
62,2008-10-03,an american carol,20000000,7013191,7022183,2008,8992,anamericancarol20081003,an american carol2008
63,2003-03-14,willard,20000000,6882696,6882696,2003,0,willard20030314,willard2003
64,2008-02-01,strange wilderness,20000000,6575282,6947084,2008,371802,strangewilderness20080201,strange wilderness2008
65,2015-04-24,little boy,20000000,6485961,17769299,2015,11283338,littleboy20150424,little boy2015
67,2012-10-26,chasing mavericks,20000000,6002756,8300821,2012,2298065,chasingmavericks20121026,chasing mavericks2012
68,2014-12-31,a most violent year,20000000,5749134,8846875,2014,3097741,amostviolentyear20141231,a most violent year2014
69,2011-11-23,a dangerous method,20000000,5702083,14807531,2011,9105448,adangerousmethod20111123,a dangerous method2011
70,2006-07-07,a scanner darkly,20000000,5501616,7405084,2006,1903468,ascannerdarkly20060707,a scanner darkly2006
71,2009-08-14,bandslam,20000000,5210988,12967829,2009,7756841,bandslam20090814,bandslam2009
72,2005-01-28,alone in the dark,20000000,5178569,10588079,2005,5409510,aloneinthedark20050128,alone in the dark2005
73,2004-10-29,birth,20000000,5005899,14603001,2004,9597102,birth20041029,birth2004
74,2016-08-26,hands of stone,20000000,4712792,5031975,2016,319183,handsofstone20160826,hands of stone2016
75,2008-10-24,passchendaele,20000000,4452423,4453327,2008,904,passchendaele20081024,passchendaele2008
76,2008-10-03,flash of genius,20000000,4442377,4504111,2008,61734,flashofgenius20081003,flash of genius2008
77,2007-11-21,iâm not there,20000000,4017609,12397613,2007,8380004,iâmnotthere20071121,iâm not there2007
78,2012-09-07,the cold light of day,20000000,3763583,25361206,2012,21597623,thecoldlightofday20120907,the cold light of day2012
79,2009-05-15,the brothers bloom,20000000,3531756,5531756,2009,2000000,thebrothersbloom20090515,the brothers bloom2009
80,2008-10-24,"synecdoche, new york",20000000,3083538,4383538,2008,1300000,synecdochenewyork20081024,"synecdoche, new york2008"
81,2018-10-26,suspiria,20000000,2483472,7034615,2018,4551143,suspiria20181026,suspiria2018
82,2017-11-03,lbj,20000000,2468683,2507181,2017,38498,lbj20171103,lbj2017
84,2004-03-19,bon voyage,20000000,2353728,8361736,2004,6008008,bonvoyage20040319,bon voyage2004
85,2015-11-13,my all-american,20000000,2246000,2246000,2015,0,myallamerican20151113,my all-american2015
87,2006-05-05,the proposition,20000000,1903434,5313608,2006,3410174,theproposition20060505,the proposition2006
88,2003-08-22,marci x,20000000,1646664,1646664,2003,0,marcix20030822,marci x2003
89,2002-12-06,equilibrium,20000000,1190018,5345869,2002,4155851,equilibrium20021206,equilibrium2002
90,2011-04-29,dylan dog: dead of night,20000000,1186538,6093725,2011,4907187,dylandogdeadofnight20110429,dylan dog: dead of night2011
91,2012-08-29,the oogieloves in the big balloon adventure,20000000,1065907,1065907,2012,0,theoogielovesinthebigballoonadventure20120829,the oogieloves in the big balloon adventure2012
92,2008-05-23,the children of huang shi,20000000,1031872,8221700,2008,7189828,thechildrenofhuangshi20080523,the children of huang shi2008
93,2000-10-20,the yards,20000000,882710,2282710,2000,1400000,theyards20001020,the yards2000
94,2010-08-06,middle men,20000000,754301,754301,2010,0,middlemen20100806,middle men2010
95,2017-04-28,jã¬yã¬ dã shä«,20000000,587470,43888531,2017,43301061,jãyãdãshä20170428,jã¬yã¬ dã shä«2017
96,2010-12-03,all good things,20000000,582024,873617,2010,291593,allgoodthings20101203,all good things2010
97,2015-11-13,by the sea,20000000,538460,3727746,2015,3189286,bythesea20151113,by the sea2015
98,2005-03-18,steamboy,20000000,468867,10468867,2005,10000000,steamboy20050318,steamboy2005
99,2005-04-22,the game of their lives,20000000,375474,375474,2005,0,thegameoftheirlives20050422,the game of their lives2005
1,2010-12-10,the tempest,20000000,277943,277943,2010,0,thetempest20101210,the tempest2010
2,2008-03-07,é·æ±ä¸è (cj7),20000000,206678,47300771,2008,47094093,éæäècj720080307,é·æ±ä¸è (cj7)2008
3,2009-09-18,the burning plain,20000000,200730,1167092,2009,966362,theburningplain20090918,the burning plain2009
5,2003-04-25,people i know,20000000,121972,5694213,2003,5572241,peopleiknow20030425,people i know2003
6,2015-10-30,regression,20000000,55039,15824374,2015,15769335,regression20151030,regression2015
7,2008-12-31,admiral,20000000,0,38585047,2008,38585047,admiral20081231,admiral2008
8,2012-12-31,zambezia,20000000,0,34454336,2012,34454336,zambezia20121231,zambezia2012
9,2010-04-13,three kingdoms: resurrection of the dragon,20000000,0,22139590,2010,22139590,threekingdomsresurrectionofthedragon20100413,three kingdoms: resurrection of the dragon2010
10,2004-03-31,the touch,20000000,0,5918742,2004,5918742,thetouch20040331,the touch2004
11,2015-05-29,survivor,20000000,0,1703281,2015,1703281,survivor20150529,survivor2015
12,2016-11-18,the history of love,20000000,0,476624,2016,476624,thehistoryoflove20161118,the history of love2016
13,2007-12-25,butterfly on a wheel,20000000,0,0,2007,0,butterflyonawheel20071225,butterfly on a wheel2007
14,2014-08-29,dwegons and leprechauns,20000000,0,0,2014,0,dwegonsandleprechauns20140829,dwegons and leprechauns2014
15,2016-07-22,fight valley,20000000,0,0,2016,0,fightvalley20160722,fight valley2016
16,2017-12-31,the thousand miles,20000000,0,0,2017,0,thethousandmiles20171231,the thousand miles2017
17,2018-12-13,bird box,19800000,0,0,2018,0,birdbox20181213,bird box2018
18,2009-08-21,der baader meinhof komplex,19700000,476270,16498827,2009,16022557,derbaadermeinhofkomplex20090821,der baader meinhof komplex2009
19,2017-12-01,the shape of water,19500000,63859435,195790794,2017,131931359,theshapeofwater20171201,the shape of water2017
20,2012-11-23,de rouille et dâos,19500000,2061449,29393634,2012,27332185,derouilleetdâos20121123,de rouille et dâos2012
21,2006-12-20,the painted veil,19400000,8060487,15118795,2006,7058308,thepaintedveil20061220,the painted veil2006
22,2013-08-23,the frozen ground,19200000,0,5617460,2013,5617460,thefrozenground20130823,the frozen ground2013
23,2011-07-29,the devil's double,19100000,1361512,5965646,2011,4604134,thedevilsdouble20110729,the devil's double2011
26,2000-07-07,scary movie,19000000,157019771,277200000,2000,120180229,scarymovie20000707,scary movie2000
27,2011-06-24,bad teacher,19000000,100292856,215448997,2011,115156141,badteacher20110624,bad teacher2011
28,2016-08-12,sausage party,19000000,97670358,141344255,2016,43673897,sausageparty20160812,sausage party2016
30,2003-01-10,just married,19000000,56127162,101564935,2003,45437773,justmarried20030110,just married2003
31,2009-09-11,i can do bad all by myself,19000000,51733921,51733921,2009,0,icandobadallbymyself20090911,i can do bad all by myself2009
32,2004-07-16,a cinderella story,19000000,51438175,70164105,2004,18725930,acinderellastory20040716,a cinderella story2004
34,2001-10-26,thirteen ghosts,19000000,41867960,68467960,2001,26600000,thirteenghosts20011026,thirteen ghosts2001
36,2010-02-26,the crazies,19000000,39123589,56445534,2010,17321945,thecrazies20100226,the crazies2010
37,2009-01-16,notorious,19000000,36843682,44972183,2009,8128501,notorious20090116,notorious2009
38,2018-11-02,nobodyâs fool,19000000,31713110,32589493,2018,876383,nobodyâsfool20181102,nobodyâs fool2018
39,2010-08-20,the switch,19000000,27758465,49858465,2010,22100000,theswitch20100820,the switch2010
40,2010-01-08,leap year,19000000,25918920,32618920,2010,6700000,leapyear20100108,leap year2010
41,2013-11-08,the book thief,19000000,21488481,76086711,2013,54598230,thebookthief20131108,the book thief2013
42,2007-10-19,"gone, baby, gone",19000000,20300218,34352162,2007,14051944,gonebabygone20071019,"gone, baby, gone2007"
43,2000-07-26,thomas and the magic railroad,19000000,15911332,15911332,2000,0,thomasandthemagicrailroad20000726,thomas and the magic railroad2000
45,2002-09-20,sen to chihiro no kamikakushi,19000000,10049886,274949886,2002,264900000,sentochihironokamikakushi20020920,sen to chihiro no kamikakushi2002
46,2008-10-17,sex drive,19000000,8402485,10412485,2008,2010000,sexdrive20081017,sex drive2008
48,2011-03-04,take me home tonight,19000000,6928068,7576604,2011,648536,takemehometonight20110304,take me home tonight2011
49,2012-09-28,won't back down,19000000,5310554,5745503,2012,434949,wontbackdown20120928,won't back down2012
50,2018-06-01,action point,19000000,5059608,5103675,2018,44067,actionpoint20180601,action point2018
53,2011-12-13,george balanchine\'s the nutcracker,19000000,2119994,2119994,2011,0,georgebalanchinesthenutcracker20111213,george balanchine\'s the nutcracker2011
55,2016-03-08,out of the inferno,19000000,0,0,2016,0,outoftheinferno20160308,out of the inferno2016
56,2005-06-24,george a. romero's land of the dead,18975000,20700082,47751015,2005,27050933,georgearomeroslandofthedead20050624,george a. romero's land of the dead2005
57,2006-12-15,indigã¨nes,18900000,320700,26063572,2006,25742872,indigãnes20061215,indigã¨nes2006
58,2005-04-15,the amityville horror,18500000,65233369,109175673,2005,43942304,theamityvillehorror20050415,the amityville horror2005
59,2002-12-06,adaptation,18500000,22498520,32531759,2002,10033239,adaptation20021206,adaptation2002
60,2009-10-02,the invention of lying,18500000,18451251,32679264,2009,14228013,theinventionoflying20091002,the invention of lying2009
62,2008-07-04,ne le dis ã personne,18500000,6198883,33954018,2008,27755135,neledisãpersonne20080704,ne le dis ã personne2008
63,2001-02-02,left behind,18500000,4221341,4221341,2001,0,leftbehind20010202,left behind2001
64,2014-05-09,neighbors,18000000,150086800,270944428,2014,120857628,neighbors20140509,neighbors2014
65,2006-11-03,borat,18000000,128505958,261443242,2006,132937284,borat20061103,borat2006
68,2001-07-13,legally blonde,18000000,96493426,141809235,2001,45315809,legallyblonde20010713,legally blonde2001
69,2004-04-30,mean girls,18000000,86047227,130953026,2004,44905799,meangirls20040430,mean girls2004
71,2005-09-09,the exorcism of emily rose,18000000,75072454,144529078,2005,69456624,theexorcismofemilyrose20050909,the exorcism of emily rose2005
73,2004-01-01,barbershop 2: back in business,18000000,65070412,65842412,2004,772000,barbershop2backinbusiness20040101,barbershop 2: back in business2004
74,2005-12-16,the family stone,18000000,60062868,92357499,2005,32294631,thefamilystone20051216,the family stone2005
75,2003-11-26,bad santa,18000000,60060328,77147031,2003,17086703,badsanta20031126,bad santa2003
77,2016-03-25,my big fat greek wedding 2,18000000,59689605,92096558,2016,32406953,mybigfatgreekwedding220160325,my big fat greek wedding 22016
78,2015-09-11,the perfect guy,18000000,57027435,60278166,2015,3250731,theperfectguy20150911,the perfect guy2015
80,2011-03-25,diary of a wimpy kid: rodrick rules,18000000,52698535,73695194,2011,20996659,diaryofawimpykidrodrickrules20110325,diary of a wimpy kid: rodrick rules2011
82,2008-04-11,prom night,18000000,43869350,57193655,2008,13324305,promnight20080411,prom night2008
83,2011-04-08,soul surfer,18000000,43853424,47158652,2011,3305228,soulsurfer20110408,soul surfer2011
84,2003-09-26,under the tuscan sun,18000000,43601508,57490024,2003,13888516,underthetuscansun20030926,under the tuscan sun2003
85,2018-06-29,uncle drew,18000000,42469946,46527161,2018,4057215,uncledrew20180629,uncle drew2018
86,2014-10-17,birdman or (the unexpected virtue of ignorance),18000000,42340598,103215094,2014,60874496,birdmanortheunexpectedvirtueofignorance20141017,birdman or (the unexpected virtue of ignorance)2014
88,2001-12-26,gosford park,18000000,41300105,41300105,2001,0,gosfordpark20011226,gosford park2001
89,2002-01-11,orange county,18000000,41059716,43308707,2002,2248991,orangecounty20020111,orange county2002
90,2013-07-26,blue jasmine,18000000,33404871,102912961,2013,69508090,bluejasmine20130726,blue jasmine2013
91,2006-04-28,united 93,18000000,31567134,77635035,2006,46067901,united9320060428,united 932006
92,2003-12-05,honey,18000000,30272254,62646763,2003,32374509,honey20031205,honey2003
93,2005-10-14,the fog,18000000,29511112,37048526,2005,7537414,thefog20051014,the fog2005
95,2015-08-07,ricki and the flash,18000000,26839498,41166033,2015,14326535,rickiandtheflash20150807,ricki and the flash2015
98,2015-11-13,love the coopers,18000000,26302731,42227490,2015,15924759,lovethecoopers20151113,love the coopers2015
100,2009-04-10,observe and report,18000000,24007324,27148898,2009,3141574,observeandreport20090410,observe and report2009
2,2009-09-18,love happens,18000000,22965110,36133014,2009,13167904,lovehappens20090918,love happens2009
3,2009-09-25,fame,18000000,22455510,80227619,2009,57772109,fame20090925,fame2009
4,2017-04-28,the circle,18000000,20497844,40651864,2017,20154020,thecircle20170428,the circle2017
6,2010-11-05,127 hours,18000000,18335230,60217171,2010,41881941,127hours20101105,127 hours2010
7,2000-05-19,small time crooks,18000000,17266359,29934477,2000,12668118,smalltimecrooks20000519,small time crooks2000
8,2000-05-12,center stage,18000000,17200925,21361109,2000,4160184,centerstage20000512,center stage2000
9,2016-01-15,norm of the north,18000000,17062499,30535660,2016,13473161,normofthenorth20160115,norm of the north2016
10,2004-02-06,catch that kid,18000000,16703799,16959614,2004,255815,catchthatkid20040206,catch that kid2004
11,2013-08-16,jobs,18000000,16131410,43402515,2013,27271105,jobs20130816,jobs2013
12,2001-10-26,life as a house,18000000,15652637,23889158,2001,8236521,lifeasahouse20011026,life as a house2001
13,2010-01-08,youth in revolt,18000000,15285588,19685588,2010,4400000,youthinrevolt20100108,youth in revolt2010
14,2014-07-25,and so it goes,18000000,15160801,17920013,2014,2759212,andsoitgoes20140725,and so it goes2014
15,2009-07-10,"i love you, beth cooper",18000000,14800725,16382538,2009,1581813,iloveyoubethcooper20090710,"i love you, beth cooper2009"
17,2001-03-30,the tailor of panama,18000000,13491653,27491653,2001,14000000,thetailorofpanama20010330,the tailor of panama2001
19,2014-01-31,labor day,18000000,13371528,14189810,2014,818282,laborday20140131,labor day2014
20,2013-08-30,getaway,18000000,10501938,11813989,2013,1312051,getaway20130830,getaway2013
22,2004-10-15,being julia,18000000,7739049,14488705,2004,6749656,beingjulia20041015,being julia2004
25,2010-01-15,the last station,18000000,6617867,15696146,2010,9078279,thelaststation20100115,the last station2010
28,2008-06-06,mongol,18000000,5705761,27147349,2008,21441588,mongol20080606,mongol2008
29,2008-10-08,rocknrolla,18000000,5700626,27794339,2008,22093713,rocknrolla20081008,rocknrolla2008
31,2010-08-20,mao's last dancer,18000000,4806750,25941437,2010,21134687,maoslastdancer20100820,mao's last dancer2010
33,2014-04-11,the railway man,18000000,4438438,23910210,2014,19471772,therailwayman20140411,the railway man2014
35,2016-03-18,midnight special,18000000,3712282,7680250,2016,3967968,midnightspecial20160318,midnight special2016
36,2016-11-25,miss sloane,18000000,3500605,7719630,2016,4219025,misssloane20161125,miss sloane2016
37,2013-09-27,metallica through the never,18000000,3419967,9082906,2013,5662939,metallicathroughthenever20130927,metallica through the never2013
38,2003-09-19,anything else,18000000,3203044,13203044,2003,10000000,anythingelse20030919,anything else2003
40,2017-03-17,t2: trainspotting,18000000,2402004,42091262,2017,39689258,t2trainspotting20170317,t2: trainspotting2017
41,2009-12-30,das weisse band: eine deutsche kindergeschichte,18000000,2222862,25727044,2009,23504182,dasweissebandeinedeutschekindergeschichte20091230,das weisse band: eine deutsche kindergeschichte2009
43,2013-03-01,phantom,18000000,1034589,1199510,2013,164921,phantom20130301,phantom2013
44,2002-04-26,the salton sea,18000000,676698,676698,2002,0,thesaltonsea20020426,the salton sea2002
45,2009-04-24,the informers,18000000,315000,315000,2009,0,theinformers20090424,the informers2009
47,2010-10-15,carlos,18000000,145526,1619153,2010,1473627,carlos20101015,carlos2010
48,2006-09-22,renaissance,18000000,70644,2401413,2006,2330769,renaissance20060922,renaissance2006
49,2008-12-31,i come with the rain,18000000,0,627422,2008,627422,icomewiththerain20081231,i come with the rain2008
50,2016-04-15,i am wrath,18000000,0,309608,2016,309608,iamwrath20160415,i am wrath2016
51,2014-11-14,wolves,18000000,0,94953,2014,94953,wolves20141114,wolves2014
52,2008-04-08,day of the dead,18000000,0,0,2008,0,dayofthedead20080408,day of the dead2008
53,2014-08-22,the prince,18000000,0,0,2014,0,theprince20140822,the prince2014
54,2016-02-19,forsaken,18000000,0,0,2016,0,forsaken20160219,forsaken2016
56,2012-07-13,red lights,17700000,49521,14518884,2012,14469363,redlights20120713,red lights2012
57,2007-08-17,superbad,17500000,121463226,169955142,2007,48491916,superbad20070817,superbad2007
58,2009-02-20,madea goes to jail,17500000,90508336,90508336,2009,0,madeagoestojail20090220,madea goes to jail2009
59,2008-02-14,step up 2 the streets,17500000,58017783,148586910,2008,90569127,stepup2thestreets20080214,step up 2 the streets2008
60,2006-01-13,hoodwinked,17500000,51386611,109843390,2006,58456779,hoodwinked20060113,hoodwinked2006
61,2004-12-22,hotel rwanda,17500000,23519128,36521223,2004,13002095,hotelrwanda20041222,hotel rwanda2004
62,2006-08-25,beerfest,17500000,19185184,20159316,2006,974132,beerfest20060825,beerfest2006
63,2013-11-27,black nativity,17500000,7018188,7285135,2013,266947,blacknativity20131127,black nativity2013
64,2003-04-25,city of ghosts,17500000,325491,325491,2003,0,cityofghosts20030425,city of ghosts2003
65,2007-12-31,taxi 4,17500000,0,60865364,2007,60865364,taxi420071231,taxi 42007
66,2018-04-06,a quiet place,17000000,188024361,334522294,2018,146497933,aquietplace20180406,a quiet place2018
67,2001-08-10,the others,17000000,96522687,207765056,2001,111242369,theothers20010810,the others2001
69,2014-08-13,letâs be cops,17000000,82390774,136890774,2014,54500000,letâsbecops20140813,letâs be cops2014
72,2004-10-22,sideways,17000000,71502303,109793192,2004,38290889,sideways20041022,sideways2004
73,2013-11-15,the best man holiday,17000000,70525195,72835710,2013,2310515,thebestmanholiday20131115,the best man holiday2013
74,2009-02-13,friday the 13th,17000000,65002019,92670237,2009,27668218,fridaythe13th20090213,friday the 13th2009
75,2012-09-28,pitch perfect,17000000,65001093,116044347,2012,51043254,pitchperfect20120928,pitch perfect2012
77,2013-04-05,evil dead,17000000,54239856,97778356,2013,43538500,evildead20130405,evil dead2013
78,2004-08-27,jet li's hero,17000000,53652140,177535958,2004,123883818,jetlishero20040827,jet li's hero2004
79,2010-10-29,saw 3d,17000000,45710178,133735284,2010,88025106,saw3d20101029,saw 3d2010
80,2015-02-20,"mcfarland, usa",17000000,44480275,45707924,2015,1227649,mcfarlandusa20150220,"mcfarland, usa2015"
81,2016-11-11,almost christmas,17000000,42065185,42493506,2016,428321,almostchristmas20161111,almost christmas2016
82,2006-03-10,the hills have eyes,17000000,41778863,70355813,2006,28576950,thehillshaveeyes20060310,the hills have eyes2006
83,2002-03-01,40 days and 40 nights,17000000,37939782,95092667,2002,57152885,40daysand40nights20020301,40 days and 40 nights2002
84,2003-10-10,good boy!,17000000,37667746,45312217,2003,7644471,goodboy20031010,good boy!2003
85,2007-01-26,smokin' aces,17000000,35662731,57263440,2007,21600709,smokinaces20070126,smokin' aces2007
87,2011-03-04,beastly,17000000,27865571,38028230,2011,10162659,beastly20110304,beastly2011
88,2010-03-05,brooklyn's finest,17000000,27163593,39233233,2010,12069640,brooklynsfinest20100305,brooklyn's finest2010
90,2010-08-20,lottery ticket,17000000,24719879,24719879,2010,0,lotteryticket20100820,lottery ticket2010
91,2003-09-05,dickie roberts: former child star,17000000,22734486,23734486,2003,1000000,dickierobertsformerchildstar20030905,dickie roberts: former child star2003
92,2006-03-31,atl,17000000,21170563,21170563,2006,0,atl20060331,atl2006
93,2001-08-24,summer catch,17000000,19693891,19693891,2001,0,summercatch20010824,summer catch2001
95,2006-03-24,larry the cable guy: health inspector,17000000,15680099,15680099,2006,0,larrythecableguyhealthinspector20060324,larry the cable guy: health inspector2006
96,2002-11-27,wes craven presents: they,17000000,12840842,16140842,2002,3300000,wescravenpresentsthey20021127,wes craven presents: they2002
100,2009-06-05,my life in ruins,17000000,8677425,20477425,2009,11800000,mylifeinruins20090605,my life in ruins2009
1,2006-04-21,american dreamz,17000000,7314027,16510971,2006,9196944,americandreamz20060421,american dreamz2006
2,2008-01-25,how she move,17000000,7070641,8607815,2008,1537174,howshemove20080125,how she move2008
3,2006-02-24,running scared,17000000,6855137,9729088,2006,2873951,runningscared20060224,running scared2006
4,2012-08-24,the apparition,17000000,4936819,10637281,2012,5700462,theapparition20120824,the apparition2012
5,2004-04-30,bobby jones: stroke of genius,17000000,2694071,2694071,2004,0,bobbyjonesstrokeofgenius20040430,bobby jones: stroke of genius2004
7,2010-12-25,l'illusionniste,17000000,2231474,8609949,2010,6378475,lillusionniste20101225,l'illusionniste2010
9,2003-10-17,veronica guerin,17000000,1569918,9438074,2003,7868156,veronicaguerin20031017,veronica guerin2003
10,2016-06-10,genius,17000000,1361045,7265283,2016,5904238,genius20160610,genius2016
11,2007-11-14,southland tales,17000000,275380,364607,2007,89227,southlandtales20071114,southland tales2007
12,2015-06-26,escobar: paradise lost,17000000,195792,3917679,2015,3721887,escobarparadiselost20150626,escobar: paradise lost2015
13,2017-09-26,"mune, le gardien de la lune",17000000,0,14534046,2017,14534046,munelegardiendelalune20170926,"mune, le gardien de la lune2017"
14,2009-06-23,chasseurs de dragons,17000000,0,13446115,2009,13446115,chasseursdedragons20090623,chasseurs de dragons2009
16,2019-07-12,crawl,17000000,0,0,2019,0,crawl20190712,crawl2019
17,2016-03-11,the young messiah,16800000,6469813,7313697,2016,843884,theyoungmessiah20160311,the young messiah2016
18,2006-11-10,fur: an imaginary portrait of diane arbus,16800000,223202,2281089,2006,2057887,furanimaginaryportraitofdianearbus20061110,fur: an imaginary portrait of diane arbus2006
22,2006-08-18,the illusionist,16500000,39868642,83792062,2006,43923420,theillusionist20060818,the illusionist2006
23,2007-08-03,becoming jane,16500000,18663911,39380876,2007,20716965,becomingjane20070803,becoming jane2007
24,2003-12-19,house of sand and fog,16500000,13005485,16157923,2003,3152438,houseofsandandfog20031219,house of sand and fog2003
25,2007-09-21,sydney white,16500000,11892415,13636339,2007,1743924,sydneywhite20070921,sydney white2007
26,2007-12-31,arn - tempelriddaren,16500000,0,21404122,2007,21404122,arntempelriddaren20071231,arn - tempelriddaren2007
30,2000-05-19,road trip,16000000,68525609,119739110,2000,51213501,roadtrip20000519,road trip2000
33,2012-05-25,moonrise kingdom,16000000,45512466,68848446,2012,23335980,moonrisekingdom20120525,moonrise kingdom2012
34,2011-11-25,the artist,16000000,44667095,128256712,2011,83589617,theartist20111125,the artist2011
35,2009-01-09,the unborn,16000000,42670410,78208812,2009,35538402,theunborn20090109,the unborn2009
36,2002-08-02,the master of disguise,16000000,40363530,40363530,2002,0,themasterofdisguise20020802,the master of disguise2002
37,2006-10-06,the texas chainsaw massacre: the beginning,16000000,39517763,50517763,2006,11000000,thetexaschainsawmassacrethebeginning20061006,the texas chainsaw massacre: the beginning2006
38,2006-12-29,el laberinto del fauno,16000000,37634615,87041569,2006,49406954,ellaberintodelfauno20061229,el laberinto del fauno2006
39,2011-02-04,the roommate,16000000,37300107,52545707,2011,15245600,theroommate20110204,the roommate2011
40,2007-02-02,the messengers,16000000,35374833,53774833,2007,18400000,themessengers20070202,the messengers2007
41,2001-03-02,see spot run,16000000,33357476,43057552,2001,9700076,seespotrun20010302,see spot run2001
43,2001-06-27,baby boy,16000000,28734552,28734552,2001,0,babyboy20010627,baby boy2001
44,2001-04-11,joe dirt,16000000,27087695,30987695,2001,3900000,joedirt20010411,joe dirt2001
45,2008-09-12,the women,16000000,26902075,50103808,2008,23201733,thewomen20080912,the women2008
46,2007-04-20,hot fuzz,16000000,23618786,81742618,2007,58123832,hotfuzz20070420,hot fuzz2007
47,2008-08-15,vicky cristina barcelona,16000000,23216709,104504817,2008,81288108,vickycristinabarcelona20080815,vicky cristina barcelona2008
48,2000-06-16,boys and girls,16000000,21799652,21799652,2000,0,boysandgirls20000616,boys and girls2000
49,2018-06-13,superfly,16000000,20537137,20723581,2018,186444,superfly20180613,superfly2018
51,2010-03-12,remember me,16000000,19068240,56506120,2010,37437880,rememberme20100312,remember me2010
52,2002-10-11,white oleander,16000000,16357770,21657770,2002,5300000,whiteoleander20021011,white oleander2002
53,2009-09-18,jennifer's body,16000000,16204793,31943401,2009,15738608,jennifersbody20090918,jennifer's body2009
54,2000-03-03,drowning mona,16000000,15427192,15980376,2000,553184,drowningmona20000303,drowning mona2000
56,2003-07-18,how to deal,16000000,14108518,14108518,2003,0,howtodeal20030718,how to deal2003
57,2014-10-03,left behind,16000000,14019924,20769209,2014,6749285,leftbehind20141003,left behind2014
58,2004-05-28,soul plane,16000000,13922211,14553807,2004,631596,soulplane20040528,soul plane2004
60,2012-06-29,people like us,16000000,12431792,12617472,2012,185680,peoplelikeus20120629,people like us2012
62,2004-09-03,the cookout,16000000,11540112,11540112,2004,0,thecookout20040903,the cookout2004
65,2016-11-18,bleed for this,16000000,5083906,6603926,2016,1520020,bleedforthis20161118,bleed for this2016
66,2002-05-03,hollywood ending,16000000,4839383,14839383,2002,10000000,hollywoodending20020503,hollywood ending2002
67,2000-09-15,duets,16000000,4734235,6615452,2000,1881217,duets20000915,duets2000
69,2007-10-19,things we lost in the fire,16000000,3287315,8120148,2007,4832833,thingswelostinthefire20071019,things we lost in the fire2007
70,2014-11-14,the homesman,16000000,2429989,8217571,2014,5787582,thehomesman20141114,the homesman2014
71,2013-04-05,trance,16000000,2322593,22594052,2013,20271459,trance20130405,trance2013
72,2014-05-16,the immigrant,16000000,2013456,7585011,2014,5571555,theimmigrant20140516,the immigrant2014
74,2005-12-21,the white countess,16000000,1669971,2814566,2005,1144595,thewhitecountess20051221,the white countess2005
75,2008-07-25,bienvenue chez les ch'tis,16000000,1477650,247474497,2008,245996847,bienvenuechezleschtis20080725,bienvenue chez les ch'tis2008
76,2014-10-01,"men, women and children",16000000,705908,1685403,2014,979495,menwomenandchildren20141001,"men, women and children2014"
77,2010-09-24,enter the void,16000000,337997,1467278,2010,1129281,enterthevoid20100924,enter the void2010
78,2008-12-31,good,16000000,31631,31631,2008,0,good20081231,good2008
79,2012-11-02,vamps,16000000,3361,94812,2012,91451,vamps20121102,vamps2012
80,2010-05-11,haeundae,16000000,0,64733391,2010,64733391,haeundae20100511,haeundae2010
81,2010-03-09,hachiko: a dog's story,16000000,0,47707417,2010,47707417,hachikoadogsstory20100309,hachiko: a dog's story2010
82,2013-12-31,zulu,16000000,0,1844228,2013,1844228,zulu20131231,zulu2013
83,2018-12-21,second act,15700000,39282227,63288854,2018,24006627,secondact20181221,second act2018
84,2002-06-21,juwanna mann,15600000,13571817,13771817,2002,200000,juwannamann20020621,juwanna mann2002
85,2007-06-08,la mã´me,15500000,10299782,88611837,2007,78312055,lamãme20070608,la mã´me2007
86,2002-11-15,ararat,15500000,1693000,1693000,2002,0,ararat20021115,ararat2002
87,2007-04-13,slow burn,15500000,1237615,1237615,2007,0,slowburn20070413,slow burn2007
88,2005-04-22,madison,15500000,517262,517262,2005,0,madison20050422,madison2005
89,2010-02-26,the yellow handkerchief,15500000,318623,318623,2010,0,theyellowhandkerchief20100226,the yellow handkerchief2010
90,2002-09-27,wasabi,15300000,81525,7000000,2002,6918475,wasabi20020927,wasabi2002
91,2006-03-31,slither,15250000,7802450,12930343,2006,5127893,slither20060331,slither2006
97,2010-11-26,the kingâs speech,15000000,138797449,430821168,2010,292023719,thekingâsspeech20101126,the kingâs speech2010
99,2000-12-08,"crouching tiger, hidden dragon",15000000,128067808,213514672,2000,85446864,crouchingtigerhiddendragon20001208,"crouching tiger, hidden dragon2000"
2,2017-08-11,annabelle: creation,15000000,102092201,305384865,2017,203292664,annabellecreation20170811,annabelle: creation2017
3,2013-10-25,jackass presents: bad grandpa,15000000,102003019,160903019,2013,58900000,jackasspresentsbadgrandpa20131025,jackass presents: bad grandpa2013
6,2014-11-28,the imitation game,15000000,91125143,227740463,2014,136615320,theimitationgame20141128,the imitation game2014
9,2013-01-18,mama,15000000,71628180,148095566,2013,76467386,mama20130118,mama2013
13,2010-03-19,diary of a wimpy kid,15000000,64003625,76954311,2010,12950686,diaryofawimpykid20100319,diary of a wimpy kid2010
15,2007-08-31,halloween,15000000,58269151,77514401,2007,19245250,halloween20070831,halloween2007
16,2006-09-30,the queen,15000000,56441711,128885873,2006,72444162,thequeen20060930,the queen2006
17,2007-10-12,why did i get married?,15000000,55204525,55934178,2007,729653,whydidigetmarried20071012,why did i get married?2007
18,2012-02-03,the woman in black,15000000,54333290,128955898,2012,74622608,thewomaninblack20120203,the woman in black2012
21,2018-08-10,blackkklansman,15000000,49275340,93017335,2018,43741995,blackkklansman20180810,blackkklansman2018
22,2006-02-03,when a stranger calls,15000000,47860214,67215435,2006,19355221,whenastrangercalls20060203,when a stranger calls2006
23,2002-02-08,big fat liar,15000000,47811275,52461017,2002,4649742,bigfatliar20020208,big fat liar2002
26,2013-02-22,snitch,15000000,42930462,57907734,2013,14977272,snitch20130222,snitch2013
27,2003-05-02,the lizzie mcguire movie,15000000,42734455,55534455,2003,12800000,thelizziemcguiremovie20030502,the lizzie mcguire movie2003
28,2015-12-04,krampus,15000000,42725475,61788393,2015,19062918,krampus20151204,krampus2015
29,2012-09-21,end of watch,15000000,41003371,57586606,2012,16583235,endofwatch20120921,end of watch2012
32,2001-12-14,not another teen movie,15000000,37882551,62401343,2001,24518792,notanotherteenmovie20011214,not another teen movie2001
33,2014-12-03,wild,15000000,37880356,52460543,2014,14580187,wild20141203,wild2014
35,2014-11-07,the theory of everything,15000000,35893537,123327692,2014,87434155,thetheoryofeverything20141107,the theory of everything2014
36,2011-09-16,drive,15000000,35060689,81357930,2011,46297241,drive20110916,drive2011
37,2000-03-31,the skulls,15000000,35007180,35007180,2000,0,theskulls20000331,the skulls2000
39,2018-11-23,the favourite,15000000,34366783,94113929,2018,59747146,thefavourite20181123,the favourite2018
40,2003-04-18,malibu's most wanted,15000000,34308901,34499204,2003,190303,malibusmostwanted20030418,malibu's most wanted2003
41,2009-09-04,all about steve,15000000,33862903,40127259,2009,6264356,allaboutsteve20090904,all about steve2009
42,2000-04-28,where the heart is,15000000,33771174,40862054,2000,7090880,wheretheheartis20000428,where the heart is2000
43,2009-08-28,halloween 2,15000000,33392973,38512850,2009,5119877,halloween220090828,halloween 22009
44,2009-03-13,the last house on the left,15000000,32752215,46526243,2009,13774028,thelasthouseontheleft20090313,the last house on the left2009
45,2005-02-18,because of winn-dixie,15000000,32647042,33508485,2005,861443,becauseofwinndixie20050218,because of winn-dixie2005
46,2005-02-04,the wedding date,15000000,31726995,47175038,2005,15448043,theweddingdate20050204,the wedding date2005
48,2002-07-12,halloween: resurrection,15000000,30259652,37659652,2002,7400000,halloweenresurrection20020712,halloween: resurrection2002
49,2007-12-25,the great debaters,15000000,30226144,30261293,2007,35149,thegreatdebaters20071225,the great debaters2007
50,2014-08-22,when the game stands tall,15000000,30127963,30138912,2014,10949,whenthegamestandstall20140822,when the game stands tall2014
52,2004-02-20,confessions of a teenage drama queen,15000000,29331068,33118854,2004,3787786,confessionsofateenagedramaqueen20040220,confessions of a teenage drama queen2004
54,2007-05-11,28 weeks later,15000000,28638916,64232714,2007,35593798,28weekslater20070511,28 weeks later2007
56,2000-04-21,love and basketball,15000000,27441122,27709625,2000,268503,loveandbasketball20000421,love and basketball2000
57,2017-09-08,home again,15000000,27020284,37336874,2017,10316590,homeagain20170908,home again2017
58,2000-10-27,book of shadows: blair witch 2,15000000,26421314,47721314,2000,21300000,bookofshadowsblairwitch220001027,book of shadows: blair witch 22000
60,2010-07-23,ramona and beezus,15000000,26167002,27469621,2010,1302619,ramonaandbeezus20100723,ramona and beezus2010
61,2014-08-27,the november man,15000000,25018119,34820335,2014,9802216,thenovemberman20140827,the november man2014
63,2005-12-28,match point,15000000,23089926,87973835,2005,64883909,matchpoint20051228,match point2005
66,2000-09-22,urban legends: final cut,15000000,21468807,38574362,2000,17105555,urbanlegendsfinalcut20000922,urban legends: final cut2000
67,2013-03-29,the place beyond the pines,15000000,21403519,47011449,2013,25607930,theplacebeyondthepines20130329,the place beyond the pines2013
68,2006-10-20,flicka,15000000,21000147,21896367,2006,896220,flicka20061020,flicka2006
69,2007-03-23,the hills have eyes ii,15000000,20804166,37466538,2007,16662372,thehillshaveeyesii20070323,the hills have eyes ii2007
70,2016-04-29,keanu,15000000,20591853,20688141,2016,96288,keanu20160429,keanu2016
71,2010-12-22,country strong,15000000,20218921,20601987,2010,383066,countrystrong20101222,country strong2010
72,2002-10-11,tuck everlasting,15000000,19161999,19344615,2002,182616,tuckeverlasting20021011,tuck everlasting2002
73,2006-10-13,the marine,15000000,18844784,22165608,2006,3320824,themarine20061013,the marine2006
76,2014-07-25,a most wanted man,15000000,17237855,36068890,2014,18831035,amostwantedman20140725,a most wanted man2014
77,2009-06-26,the hurt locker,15000000,17017811,49894223,2009,32876412,thehurtlocker20090626,the hurt locker2009
78,2000-01-28,eye of the beholder,15000000,16500786,18260865,2000,1760079,eyeofthebeholder20000128,eye of the beholder2000
79,2012-11-02,the man with the iron fists,15000000,15634090,22018988,2012,6384898,themanwiththeironfists20121102,the man with the iron fists2012
81,2019-02-01,miss bala,15000000,14998027,15362298,2019,364271,missbala20190201,miss bala2019
82,2012-11-30,killing them softly,15000000,14945541,39238443,2012,24292902,killingthemsoftly20121130,killing them softly2012
83,2001-04-20,freddy got fingered,15000000,14249005,14249005,2001,0,freddygotfingered20010420,freddy got fingered2001
84,2011-08-19,one day,15000000,13843771,59168692,2011,45324921,oneday20110819,one day2011
85,2004-06-25,de-lovely,15000000,13337299,18524496,2004,5187197,delovely20040625,de-lovely2004
86,2009-10-02,whip it,15000000,13077184,18889972,2009,5812788,whipit20091002,whip it2009
87,2008-01-11,the pirates who don't do anything: a veggietales movie,15000000,12981269,13248444,2008,267175,thepirateswhodontdoanythingaveggietalesmovie20080111,the pirates who don't do anything: a veggietales movie2008
88,2008-01-23,u2 3d,15000000,12898847,26170402,2008,13271555,u23d20080123,u2 3d2008
89,2000-09-01,highlander: endgame,15000000,12801190,12801190,2000,0,highlanderendgame20000901,highlander: endgame2000
90,2017-01-20,the founder,15000000,12786053,24403192,2017,11617139,thefounder20170120,the founder2017
91,2006-08-25,idlewild,15000000,12669914,12669914,2006,0,idlewild20060825,idlewild2006
92,2003-04-25,confidence,15000000,12212417,12212417,2003,0,confidence20030425,confidence2003
93,2002-10-11,knockaround guys,15000000,11660180,12419700,2002,759520,knockaroundguys20021011,knockaround guys2002
98,2000-03-24,here on earth,15000000,10494147,10845127,2000,350980,hereonearth20000324,here on earth2000
99,2004-10-08,raise your voice,15000000,10411980,14811980,2004,4400000,raiseyourvoice20041008,raise your voice2004
2,2007-03-02,black snake moan,15000000,9396870,10951153,2007,1554283,blacksnakemoan20070302,black snake moan2007
3,2003-02-21,dark blue,15000000,9237470,12262065,2003,3024595,darkblue20030221,dark blue2003
4,2007-06-22,a mighty heart,15000000,9176787,19153568,2007,9976781,amightyheart20070622,a mighty heart2007
6,2016-09-23,queen of katwe,15000000,8874389,10055481,2016,1181092,queenofkatwe20160923,queen of katwe2016
7,2000-03-24,whatever it takes,15000000,8735529,8735529,2000,0,whateverittakes20000324,whatever it takes2000
8,2003-03-21,boat trip,15000000,8586376,14933713,2003,6347337,boattrip20030321,boat trip2003
9,2002-05-22,the importance of being earnest,15000000,8378141,8378141,2002,0,theimportanceofbeingearnest20020522,the importance of being earnest2002
11,2006-05-05,hoot,15000000,8117637,8224998,2006,107361,hoot20060505,hoot2006
12,2008-02-08,in bruges,15000000,7800825,34533783,2008,26732958,inbruges20080208,in bruges2008
13,2013-01-04,promised land,15000000,7597898,12394562,2013,4796664,promisedland20130104,promised land2013
14,2001-10-08,mulholland drive,15000000,7219578,20785973,2001,13566395,mulhollanddrive20011008,mulholland drive2001
15,2018-06-08,hotel artemis,15000000,6708137,12758799,2018,6050662,hotelartemis20180608,hotel artemis2018
16,2008-08-20,the rocker,15000000,6409528,8767338,2008,2357810,therocker20080820,the rocker2008
17,2009-08-21,post grad,15000000,6382178,6563402,2009,181224,postgrad20090821,post grad2009
18,2009-06-19,whatever works,15000000,5306706,35106706,2009,29800000,whateverworks20090619,whatever works2009
19,2000-07-19,the in crowd,15000000,5217498,5217498,2000,0,theincrowd20000719,the in crowd2000
20,2005-12-14,los tres entierros de melquiades estrada,15000000,5027684,13454474,2005,8426790,lostresentierrosdemelquiadesestrada20051214,los tres entierros de melquiades estrada2005
22,2007-09-28,se jie,15000000,4604982,65167430,2007,60562448,sejie20070928,se jie2007
23,2005-10-21,"kiss kiss, bang bang",15000000,4235837,16829464,2005,12593627,kisskissbangbang20051021,"kiss kiss, bang bang2005"
25,2015-10-30,scouts guide to the zombie apocalypse,15000000,3703046,15554855,2015,11851809,scoutsguidetothezombieapocalypse20151030,scouts guide to the zombie apocalypse2015
26,2007-01-26,blood and chocolate,15000000,3526588,6551310,2007,3024722,bloodandchocolate20070126,blood and chocolate2007
27,2010-09-22,you will meet a tall dark stranger,15000000,3247816,34247816,2010,31000000,youwillmeetatalldarkstranger20100922,you will meet a tall dark stranger2010
28,2015-10-23,rock the kasbah,15000000,3020665,3386153,2015,365488,rockthekasbah20151023,rock the kasbah2015
29,2010-09-15,never let me go,15000000,2434652,11173718,2010,8739066,neverletmego20100915,never let me go2010
30,2016-09-09,the disappointments room,15000000,2423467,3503761,2016,1080294,thedisappointmentsroom20160909,the disappointments room2016
31,2003-12-25,the company,15000000,2281585,3396508,2003,1114923,thecompany20031225,the company2003
32,2008-07-18,transsiberian,15000000,2203641,6379575,2008,4175934,transsiberian20080718,transsiberian2008
35,2017-02-03,the comedian,15000000,1658706,1658706,2017,0,thecomedian20170203,the comedian2017
36,2008-03-14,funny games,15000000,1294640,8200127,2008,6905487,funnygames20080314,funny games2008
37,2006-06-02,banlieue 13,15000000,1200216,11599903,2006,10399687,banlieue1320060602,banlieue 132006
39,2002-01-25,metropolis,15000000,673414,1405032,2002,731618,metropolis20020125,metropolis2002
40,2015-10-16,cã¬kã¨ niã¨ yinniã¡ng,15000000,632542,11279884,2015,10647342,cãkãniãyinniãng20151016,cã¬kã¨ niã¨ yinniã¡ng2015
42,2013-04-26,the reluctant fundamentalist,15000000,528731,528731,2013,0,thereluctantfundamentalist20130426,the reluctant fundamentalist2013
43,2004-02-06,the return,15000000,501752,5953886,2004,5452134,thereturn20040206,the return2004
44,2003-07-25,buffalo soldiers,15000000,353743,353743,2003,0,buffalosoldiers20030725,buffalo soldiers2003
45,2003-04-25,steal (canadian release),15000000,220944,220944,2003,0,stealcanadianrelease20030425,steal (canadian release)2003
46,2010-08-27,centurion,15000000,123570,7885048,2010,7761478,centurion20100827,centurion2010
47,2009-10-23,ong-bak 2,15000000,102458,7583050,2009,7480592,ongbak220091023,ong-bak 22009
49,2008-08-01,midnight meat train,15000000,73548,1590246,2008,1516698,midnightmeattrain20080801,midnight meat train2008
50,2013-09-06,winnie mandela,15000000,61847,61847,2013,0,winniemandela20130906,winnie mandela2013
51,2011-11-04,the son of no one,15000000,30680,1148578,2011,1117898,thesonofnoone20111104,the son of no one2011
52,2002-10-25,all the queen's men,15000000,22723,22723,2002,0,allthequeensmen20021025,all the queen's men2002
53,2007-10-05,the good night,15000000,22441,22441,2007,0,thegoodnight20071005,the good night2007
54,2013-12-06,khumba,15000000,0,20898221,2013,20898221,khumba20131206,khumba2013
55,2015-05-05,a few best men,15000000,0,17224539,2015,17224539,afewbestmen20150505,a few best men2015
56,2014-10-10,autã³mata,15000000,0,6775458,2014,6775458,autã³mata20141010,autã³mata2014
57,2015-12-31,chiamatemi francesco - il papa della gente,15000000,0,3925769,2015,3925769,chiamatemifrancescoilpapadellagente20151231,chiamatemi francesco - il papa della gente2015
58,2008-12-31,bathory,15000000,0,3436763,2008,3436763,bathory20081231,bathory2008
59,2010-02-05,san suk si gin,15000000,0,2013340,2010,2013340,sansuksigin20100205,san suk si gin2010
60,2005-12-31,dungeons & dragons: wrath of the dragon god,15000000,0,909822,2005,909822,dungeonsdragonswrathofthedragongod20051231,dungeons & dragons: wrath of the dragon god2005
61,2017-02-17,in dubious battle,15000000,0,214182,2017,214182,indubiousbattle20170217,in dubious battle2017
62,2015-09-01,broken horses,15000000,0,3471,2015,3471,brokenhorses20150901,broken horses2015
63,2001-06-29,pandaemonium,15000000,0,0,2001,0,pandaemonium20010629,pandaemonium2001
64,2019-08-14,blinded by the light,15000000,0,0,2019,0,blindedbythelight20190814,blinded by the light2019
66,2015-07-01,magic mike xxl,14500000,66013057,123660597,2015,57647540,magicmikexxl20150701,magic mike xxl2015
68,2011-07-22,elle s'appelait sarah,14500000,7691700,25480031,2011,17788331,ellesappelaitsarah20110722,elle s'appelait sarah2011
69,2015-06-05,freedom,14500000,0,872757,2015,872757,freedom20150605,freedom2015
71,2006-01-27,manderlay,14200000,74205,543306,2006,469101,manderlay20060127,manderlay2006
74,2008-11-12,slumdog millionaire,14000000,141330703,384530440,2008,243199737,slumdogmillionaire20081112,slumdog millionaire2008
79,2007-01-12,stomp the yard,14000000,61356221,75525718,2007,14169497,stomptheyard20070112,stomp the yard2007
80,2009-01-16,my bloody valentine,14000000,51545952,102836002,2009,51290050,mybloodyvalentine20090116,my bloody valentine2009
81,2012-08-31,the possession,14000000,49130588,82925064,2012,33794476,thepossession20120831,the possession2012
86,2012-02-24,tyler perry's good deeds,14000000,35025791,35579177,2012,553386,tylerperrysgooddeeds20120224,tyler perry's good deeds2012
90,2012-01-13,the iron lady,14000000,29959436,115592104,2012,85632668,theironlady20120113,the iron lady2012
92,2002-10-04,jonah: a veggietales movie,14000000,25571351,25608779,2002,37428,jonahaveggietalesmovie20021004,jonah: a veggietales movie2002
93,2002-03-08,all about the benjamins,14000000,25482931,25873145,2002,390214,allaboutthebenjamins20020308,all about the benjamins2002
95,2010-03-12,our family wedding,14000000,20255281,21410546,2010,1155265,ourfamilywedding20100312,our family wedding2010
97,2006-05-05,an american haunting,14000000,16298046,30443277,2006,14145231,anamericanhaunting20060505,an american haunting2006
98,2003-08-22,my boss's daughter,14000000,15549702,15549702,2003,0,mybosssdaughter20030822,my boss's daughter2003
99,2009-08-07,a perfect getaway,14000000,15515460,22815460,2009,7300000,aperfectgetaway20090807,a perfect getaway2009
4,2002-04-26,jason x,14000000,13121555,16951798,2002,3830243,jasonx20020426,jason x2002
6,2007-03-16,i think i love my wife,14000000,12559771,13205411,2007,645640,ithinkilovemywife20070316,i think i love my wife2007
7,2015-02-20,hot tub time machine 2,14000000,12314651,12826644,2015,511993,hottubtimemachine220150220,hot tub time machine 22015
8,2006-11-17,bobby,14000000,11242801,20597806,2006,9355005,bobby20061117,bobby2006
9,2001-02-02,head over heels,14000000,10397365,10397365,2001,0,headoverheels20010202,head over heels2001
10,2012-10-26,fun size,14000000,9409538,11166615,2012,1757077,funsize20121026,fun size2012
12,2007-11-30,le scaphandre et le papillon,14000000,5990075,22754472,2007,16764397,lescaphandreetlepapillon20071130,le scaphandre et le papillon2007
13,2006-10-06,little children,14000000,5463019,14121177,2006,8658158,littlechildren20061006,little children2006
14,2000-04-21,gossip,14000000,5108820,12591270,2000,7482450,gossip20000421,gossip2000
16,2015-10-23,suffragette,14000000,4702420,34044909,2015,29342489,suffragette20151023,suffragette2015
17,2006-10-27,catch a fire,14000000,4299773,5782198,2006,1482425,catchafire20061027,catch a fire2006
18,2014-12-19,mr. turner,14000000,3958546,25187026,2014,21228480,mrturner20141219,mr. turner2014
19,2001-09-07,soul survivors,14000000,3100650,4288246,2001,1187596,soulsurvivors20010907,soul survivors2001
20,2009-05-22,easy virtue,14000000,2656784,20537741,2009,17880957,easyvirtue20090522,easy virtue2009
22,2010-08-06,flipped,14000000,1755212,4289993,2010,2534781,flipped20100806,flipped2010
24,2010-06-25,les herbes folles,14000000,403952,1903952,2010,1500000,lesherbesfolles20100625,les herbes folles2010
25,2003-01-24,amen,14000000,274299,274299,2003,0,amen20030124,amen2003
26,2008-09-26,the lucky ones,14000000,266967,266967,2008,0,theluckyones20080926,the lucky ones2008
27,2011-09-30,margaret,14000000,47185,623292,2011,576107,margaret20110930,margaret2011
28,2016-11-01,reign of assassins,14000000,0,11354230,2016,11354230,reignofassassins20161101,reign of assassins2016
29,2009-10-27,stan helsing: a parody,14000000,0,1553556,2009,1553556,stanhelsingaparody20091027,stan helsing: a parody2009
30,2005-12-09,brokeback mountain,13900000,83043761,176980863,2005,93937102,brokebackmountain20051209,brokeback mountain2005
32,2008-12-31,ca$h,13700000,0,11738256,2008,11738256,cah20081231,ca$h2008
35,2002-11-08,far from heaven,13500000,15901849,29027914,2002,13126065,farfromheaven20021108,far from heaven2002
36,2012-10-12,seven psychopaths,13500000,15024049,33035736,2012,18011687,sevenpsychopaths20121012,seven psychopaths2012
37,2000-11-22,quills,13500000,7060876,11732088,2000,4671212,quills20001122,quills2000
39,2005-02-18,der untergang,13500000,5501940,93631744,2005,88129804,deruntergang20050218,der untergang2005
40,2001-03-02,the caveman's valentine,13500000,687081,892506,2001,205425,thecavemansvalentine20010302,the caveman's valentine2001
41,2011-04-01,the last godfather,13400000,164247,164247,2011,0,thelastgodfather20110401,the last godfather2011
42,2014-04-04,under the skin,13300000,2614251,7229933,2014,4615682,undertheskin20140404,under the skin2014
43,2004-12-17,mar adentro,13300000,2086345,39686345,2004,37600000,maradentro20041217,mar adentro2004
44,2014-09-12,no good deed,13200000,52543632,54323210,2014,1779578,nogooddeed20140912,no good deed2014
46,2010-12-03,black swan,13000000,106954678,331266710,2010,224312032,blackswan20101203,black swan2010
47,2001-01-12,save the last dance,13000000,91038276,122244329,2001,31206053,savethelastdance20010112,save the last dance2001
48,2011-02-11,justin bieber: never say never,13000000,73013910,99034125,2011,26020215,justinbieberneversaynever20110211,justin bieber: never say never2011
49,2018-07-04,the first purge,13000000,69488745,136617305,2018,67128560,thefirstpurge20180704,the first purge2018
50,2016-03-16,miracles from heaven,13000000,61705123,73798736,2016,12093613,miraclesfromheaven20160316,miracles from heaven2016
51,2000-02-11,snow day,13000000,60008303,62452927,2000,2444624,snowday20000211,snow day2000
52,2004-01-23,the butterfly effect,13000000,57924679,95638592,2004,37713913,thebutterflyeffect20040123,the butterfly effect2004
54,2016-06-24,the shallows,13000000,55121623,118763442,2016,63641819,theshallows20160624,the shallows2016
57,2007-11-21,this christmas,13000000,49121934,49733545,2007,611611,thischristmas20071121,this christmas2007
58,2014-02-14,about last night,13000000,48637684,50445860,2014,1808176,aboutlastnight20140214,about last night2014
59,2000-12-15,"dude, where's my car?",13000000,46729374,73180297,2000,26450923,dudewheresmycar20001215,"dude, where's my car?2000"
61,2014-10-10,st. vincent,13000000,44137712,54837234,2014,10699522,stvincent20141010,st. vincent2014
62,2014-07-02,earth to echo,13000000,38934842,42174545,2014,3239703,earthtoecho20140702,earth to echo2014
64,2002-05-10,the new guy,13000000,28972187,28972187,2002,0,thenewguy20020510,the new guy2002
70,2013-03-01,21 and over,13000000,25682380,42195766,2013,16513386,21andover20130301,21 and over2013
71,2007-11-21,the mist,13000000,25593755,57189408,2007,31595653,themist20071121,the mist2007
72,2015-04-10,ex machina,13000000,25440971,38358392,2015,12917421,exmachina20150410,ex machina2015
74,2001-09-07,two can play that game,13000000,22235901,22391450,2001,155549,twocanplaythatgame20010907,two can play that game2001
75,2016-03-11,eye in the sky,13000000,18704596,35402802,2016,16698206,eyeinthesky20160311,eye in the sky2016
76,2013-03-22,admission,13000000,18007317,18733666,2013,726349,admission20130322,admission2013
77,2012-09-21,the perks of being a wallflower,13000000,17742948,33069303,2012,15326355,theperksofbeingawallflower20120921,the perks of being a wallflower2012
78,2001-06-29,crazy/beautiful,13000000,16929123,19929123,2001,3000000,crazybeautiful20010629,crazy/beautiful2001
80,2015-10-16,room,13000000,14677674,36262783,2015,21585109,room20151016,room2015
81,2015-10-16,woodlawn,13000000,14394097,14403703,2015,9606,woodlawn20151016,woodlawn2015
82,2006-12-20,letters from iwo jima,13000000,13756082,67867998,2006,54111916,lettersfromiwojima20061220,letters from iwo jima2006
83,2009-05-29,mã¤n som hatar kvinnor,13000000,12749992,109421911,2009,96671919,mãnsomhatarkvinnor20090529,mã¤n som hatar kvinnor2009
84,2007-02-23,the astronaut farmer,13000000,11003643,11141213,2007,137570,theastronautfarmer20070223,the astronaut farmer2007
86,2015-07-17,bajrangi bhaijaan,13000000,8178001,121778347,2015,113600346,bajrangibhaijaan20150717,bajrangi bhaijaan2015
88,2016-09-09,robinson crusoe,13000000,8005586,42446455,2016,34440869,robinsoncrusoe20160909,robinson crusoe2016
92,2001-08-24,bubble boy,13000000,5002310,5002310,2001,0,bubbleboy20010824,bubble boy2001
93,2002-02-01,birthday girl,13000000,4919896,8130727,2002,3210831,birthdaygirl20020201,birthday girl2002
94,2007-05-04,"paris, je t'aime",13000000,4857374,5175088,2007,317714,parisjetaime20070504,"paris, je t'aime2007"
95,2018-12-07,ben is back,13000000,3703182,9633111,2018,5929929,benisback20181207,ben is back2018
96,2007-08-24,resurrecting the champ,13000000,3172382,3260555,2007,88173,resurrectingthechamp20070824,resurrecting the champ2007
97,2010-03-26,chloe,13000000,3075255,11831131,2010,8755876,chloe20100326,chloe2010
98,2001-03-02,the widow of st. pierre,13000000,3058380,3058380,2001,0,thewidowofstpierre20010302,the widow of st. pierre2001
99,2015-12-04,youth,13000000,2703296,24001573,2015,21298277,youth20151204,youth2015
1,2010-02-26,un prophã¨te,13000000,2087720,19910624,2010,17822904,unprophãte20100226,un prophã¨te2010
2,2010-12-03,"i love you, phillip morris",13000000,2037459,23014027,2010,20976568,iloveyouphillipmorris20101203,"i love you, phillip morris2010"
3,2015-07-24,the vatican tapes,13000000,1784763,14929184,2015,13144421,thevaticantapes20150724,the vatican tapes2015
4,2006-03-17,find me guilty,13000000,1173673,2898225,2006,1724552,findmeguilty20060317,find me guilty2006
6,2006-10-13,infamous,13000000,1151330,2613717,2006,1462387,infamous20061013,infamous2006
7,2011-07-29,attack the block,13000000,1024175,6459183,2011,5435008,attacktheblock20110729,attack the block2011
8,2015-08-14,brothers,13000000,656688,17856688,2015,17200000,brothers20150814,brothers2015
9,2000-12-29,the claim,13000000,622023,1375635,2000,753612,theclaim20001229,the claim2000
10,2011-12-23,in the land of blood and honey,13000000,303877,509193,2011,205316,inthelandofbloodandhoney20111223,in the land of blood and honey2011
11,2010-06-18,the killer inside me,13000000,217277,3617277,2010,3400000,thekillerinsideme20100618,the killer inside me2010
12,2012-03-30,womb,13000000,0,0,2012,0,womb20120330,womb2012
13,2019-12-31,rogue city,13000000,0,0,2019,0,roguecity20191231,rogue city2019
14,2013-03-15,the call,12800000,51872378,69821476,2013,17949098,thecall20130315,the call2013
15,2016-08-05,operation chromite,12700000,1022720,49196532,2016,48173812,operationchromite20160805,operation chromite2016
16,2014-09-12,the drop,12600000,10724389,19054534,2014,8330145,thedrop20140912,the drop2014
17,2002-07-12,the crocodile hunter: collision course,12500000,28436931,33436931,2002,5000000,thecrocodilehuntercollisioncourse20020712,the crocodile hunter: collision course2002
18,2010-09-03,machete,12500000,26593646,46370970,2010,19777324,machete20100903,machete2010
19,2002-12-19,antwone fisher,12500000,21078145,23367586,2002,2289441,antwonefisher20021219,antwone fisher2002
21,2002-11-22,the emperor's club,12500000,14060950,16193713,2002,2132763,theemperorsclub20021122,the emperor's club2002
23,2009-09-11,sorority row,12500000,11965282,26735797,2009,14770515,sororityrow20090911,sorority row2009
25,2008-11-07,the boy in the striped pyjamas,12500000,9046156,44083403,2008,35037247,theboyinthestripedpyjamas20081107,the boy in the striped pyjamas2008
28,2010-10-15,conviction,12500000,6797696,11826980,2010,5029284,conviction20101015,conviction2010
29,2007-10-12,lars and the real girl,12500000,5956480,11277119,2007,5320639,larsandtherealgirl20071012,lars and the real girl2007
30,2010-05-21,solitary man,12500000,4360548,4360548,2010,0,solitaryman20100521,solitary man2010
31,2000-09-22,dancer in the dark,12500000,4157491,45557491,2000,41400000,dancerinthedark20000922,dancer in the dark2000
32,2010-12-17,casino jack,12500000,2039869,2272186,2010,232317,casinojack20101217,casino jack2010
35,2004-09-03,tae guik gi: the brotherhood of war,12500000,1110186,69826708,2004,68716522,taeguikgithebrotherhoodofwar20040903,tae guik gi: the brotherhood of war2004
36,2010-04-16,the perfect game,12500000,1089445,3931367,2010,2841922,theperfectgame20100416,the perfect game2010
37,2012-10-05,the paperboy,12500000,677200,4027663,2012,3350463,thepaperboy20121005,the paperboy2012
38,2013-03-01,ernest et celestine,12500000,292562,9376444,2013,9083882,ernestetcelestine20130301,ernest et celestine2013
39,2012-05-04,a little bit of heaven,12500000,10011,1100287,2012,1090276,alittlebitofheaven20120504,a little bit of heaven2012
43,2014-06-06,the fault in our stars,12000000,124872350,307166834,2014,182294484,thefaultinourstars20140606,the fault in our stars2014
45,2012-04-20,think like a man,12000000,91547205,113373764,2012,21826559,thinklikeaman20120420,think like a man2012
46,2014-04-16,heaven is for real,12000000,91386097,100916299,2014,9530202,heavenisforreal20140416,heaven is for real2014
49,2002-09-13,barbershop,12000000,75781642,77063461,2002,1281819,barbershop20020913,barbershop2002
52,2012-02-24,act of valor,12000000,70012847,82497035,2012,12484188,actofvalor20120224,act of valor2012
54,2006-08-11,step up,12000000,65328121,110989157,2006,45661036,stepup20060811,step up2006
55,2012-02-03,chronicle,12000000,64575175,123681790,2012,59106615,chronicle20120203,chronicle2012
58,2012-03-02,project x,12000000,54731865,103028188,2012,48296323,projectx20120302,project x2012
59,2017-11-10,"three billboards outside ebbing, missouri",12000000,54513740,160191915,2017,105678175,threebillboardsoutsideebbingmissouri20171110,"three billboards outside ebbing, missouri2017"
60,2016-11-25,lion,12000000,51739495,149570720,2016,97831225,lion20161125,lion2016
61,2018-05-04,overboard,12000000,50316123,85369830,2018,35053707,overboard20180504,overboard2018
64,2008-04-25,harold & kumar escape from guantanamo bay,12000000,38108728,43353117,2008,5244389,haroldkumarescapefromguantanamobay20080425,harold & kumar escape from guantanamo bay2008
65,2013-11-22,philomena,12000000,37709979,98963392,2013,61253413,philomena20131122,philomena2013
67,2002-02-15,crossroads,12000000,37188667,57000000,2002,19811333,crossroads20020215,crossroads2002
68,2015-07-24,paper towns,12000000,32000304,85450484,2015,53450180,papertowns20150724,paper towns2015
69,2008-10-10,quarantine,12000000,31691811,41924774,2008,10232963,quarantine20081010,quarantine2008
70,2002-08-21,one hour photo,12000000,31597131,52223306,2002,20626175,onehourphoto20020821,one hour photo2002
71,2008-02-01,the eye,12000000,31418697,57577765,2008,26159068,theeye20080201,the eye2008
72,2004-04-07,johnson family vacation,12000000,31203964,31286759,2004,82795,johnsonfamilyvacation20040407,johnson family vacation2004
73,2001-12-21,how high,12000000,31155435,31222395,2001,66960,howhigh20011221,how high2001
75,2006-09-01,crank,12000000,27838408,43924923,2006,16086515,crank20060901,crank2006
77,2016-08-12,hell or high water,12000000,27007844,37584304,2016,10576460,hellorhighwater20160812,hell or high water2016
78,2002-10-25,frida,12000000,25885000,56131239,2002,30246239,frida20021025,frida2002
79,2012-07-05,katy perry: part of me,12000000,25326071,32700439,2012,7374368,katyperrypartofme20120705,katy perry: part of me2012
80,2014-12-12,top five,12000000,25317379,26001741,2014,684362,topfive20141212,top five2014
84,2015-01-30,project almanac,12000000,22348241,32909437,2015,10561196,projectalmanac20150130,project almanac2015
85,2010-05-14,just wright,12000000,21540363,21867665,2010,327302,justwright20100514,just wright2010
89,2005-03-11,the upside of anger,12000000,18761993,28915761,2005,10153768,theupsideofanger20050311,the upside of anger2005
90,2006-03-03,aquamarine,12000000,18597342,22978953,2006,4381611,aquamarine20060303,aquamarine2006
91,2013-11-15,nebraska,12000000,17654912,24761360,2013,7106448,nebraska20131115,nebraska2013
92,2004-01-09,my baby's daddy,12000000,17321573,17322212,2004,639,mybabysdaddy20040109,my baby's daddy2004
93,2001-10-05,max keeble's big move,12000000,17292381,17292381,2001,0,maxkeeblesbigmove20011005,max keeble's big move2001
94,2011-12-09,young adult,12000000,16311571,22750356,2011,6438785,youngadult20111209,young adult2011
95,2013-11-01,about time,12000000,15323921,89309178,2013,73985257,abouttime20131101,about time2013
96,2018-12-14,if beale street could talk,12000000,14915773,19859167,2018,4943394,ifbealestreetcouldtalk20181214,if beale street could talk2018
97,2017-07-14,wish upon,12000000,14301505,23477345,2017,9175840,wishupon20170714,wish upon2017
100,2008-10-03,rachel getting married,12000000,12796861,17475475,2008,4678614,rachelgettingmarried20081003,rachel getting married2008
2,2003-12-12,girl with a pearl earring,12000000,11634362,43274797,2003,31640435,girlwithapearlearring20031212,girl with a pearl earring2003
4,2017-04-21,unforgettable,12000000,11368012,16221211,2017,4853199,unforgettable20170421,unforgettable2017
5,2004-12-03,house of flying daggers,12000000,11050094,92863945,2004,81813851,houseofflyingdaggers20041203,house of flying daggers2004
6,2002-03-22,sorority boys,12000000,10198766,12516222,2002,2317456,sororityboys20020322,sorority boys2002
7,2017-10-13,marshall,12000000,10051659,10116816,2017,65157,marshall20171013,marshall2017
8,2008-12-05,cadillac records,12000000,8195551,8942516,2008,746965,cadillacrecords20081205,cadillac records2008
9,2012-09-14,arbitrage,12000000,7919574,35830713,2012,27911139,arbitrage20120914,arbitrage2012
11,2000-05-12,screwed,12000000,6982680,6982680,2000,0,screwed20000512,screwed2000
12,2006-10-20,running with scissors,12000000,6860000,8706701,2006,1846701,runningwithscissors20061020,running with scissors2006
14,2012-06-01,for greater glory: the true story of cristiada,12000000,5669081,10026255,2012,4357174,forgreaterglorythetruestoryofcristiada20120601,for greater glory: the true story of cristiada2012
15,2006-11-17,for your consideration,12000000,5549923,5549923,2006,0,foryourconsideration20061117,for your consideration2006
17,2003-06-20,from justin to kelly,12000000,4922166,4922166,2003,0,fromjustintokelly20030620,from justin to kelly2003
20,2003-10-22,in the cut,12000000,4717455,23693646,2003,18976191,inthecut20031022,in the cut2003
21,2008-02-22,charlie bartlett,12000000,3950294,5295909,2008,1345615,charliebartlett20080222,charlie bartlett2008
22,2009-02-13,two lovers,12000000,3149034,16349034,2009,13200000,twolovers20090213,two lovers2009
23,2013-11-15,la grande bellezza,12000000,2883879,29549145,2013,26665266,lagrandebellezza20131115,la grande bellezza2013
24,2002-02-15,last orders,12000000,2326407,2326407,2002,0,lastorders20020215,last orders2002
25,2007-03-09,gwoemul,12000000,2201923,92618117,2007,90416194,gwoemul20070309,gwoemul2007
28,2002-06-14,the dangerous lives of altar boys,12000000,1779284,1779284,2002,0,thedangerouslivesofaltarboys20020614,the dangerous lives of altar boys2002
29,2013-03-01,stoker,12000000,1703125,12034913,2013,10331788,stoker20130301,stoker2013
30,2008-03-07,married life,12000000,1506998,2975188,2008,1468190,marriedlife20080307,married life2008
31,2005-08-05,2046,12000000,1442338,19287485,2005,17845147,204620050805,20462005
32,2011-03-11,kill the irishman,12000000,1188194,1188194,2011,0,killtheirishman20110311,kill the irishman2011
33,2005-09-30,duma,12000000,870067,994790,2005,124723,duma20050930,duma2005
34,2012-04-20,darling companion,12000000,793352,1200346,2012,406994,darlingcompanion20120420,darling companion2012
35,2010-06-04,ondine,12000000,550472,557545,2010,7073,ondine20100604,ondine2010
36,2001-07-20,brother,12000000,450594,450594,2001,0,brother20010720,brother2001
37,2002-10-04,welcome to collinwood,12000000,378650,4606284,2002,4227634,welcometocollinwood20021004,welcome to collinwood2002
38,2008-04-18,life before her eyes,12000000,303439,7203439,2008,6900000,lifebeforehereyes20080418,life before her eyes2008
40,2007-09-28,trade,12000000,214202,1513388,2007,1299186,trade20070928,trade2007
41,2006-01-06,fateless,12000000,196857,196857,2006,0,fateless20060106,fateless2006
42,2010-09-03,san qiang pai an jing qi,12000000,190946,310946,2010,120000,sanqiangpaianjingqi20100903,san qiang pai an jing qi2010
44,2001-03-09,company man,12000000,146028,622273,2001,476245,companyman20010309,company man2001
45,2009-11-07,nanjing! nanjing!,12000000,122558,20122558,2009,20000000,nanjingnanjing20091107,nanjing! nanjing!2009
46,2015-10-09,trash,12000000,17484,6553186,2015,6535702,trash20151009,trash2015
47,2011-08-19,5 days of war,12000000,17479,87793,2011,70314,5daysofwar20110819,5 days of war2011
48,2015-11-11,10 days in a madhouse,12000000,14616,14616,2015,0,10daysinamadhouse20151111,10 days in a madhouse2015
49,2009-04-07,1612,12000000,0,5400624,2009,5400624,161220090407,16122009
50,2015-12-31,san cheng ji,12000000,0,1950194,2015,1950194,sanchengji20151231,san cheng ji2015
51,2011-12-31,tu xia chuan qi,12000000,0,1828400,2011,1828400,tuxiachuanqi20111231,tu xia chuan qi2011
52,2010-02-10,triangle,12000000,0,1594955,2010,1594955,triangle20100210,triangle2010
53,2013-10-19,supesu batorushippu yamato,12000000,0,0,2013,0,supesubatorushippuyamato20131019,supesu batorushippu yamato2013
54,2014-10-03,drive hard,12000000,0,0,2014,0,drivehard20141003,drive hard2014
55,2015-10-30,dancin' it's on,12000000,0,0,2015,0,dancinitson20151030,dancin' it's on2015
56,2009-06-05,home,12000000,0,0,2009,0,home20090605,home2009
57,2016-09-23,the dressmaker,11900000,2022115,24041617,2016,22019502,thedressmaker20160923,the dressmaker2016
60,2015-11-20,carol,11800000,12711491,42843521,2015,30132030,carol20151120,carol2015
62,2016-01-22,dirty grandpa,11500000,35593113,105078449,2016,69485336,dirtygrandpa20160122,dirty grandpa2016
63,2009-11-27,the cry of the owl,11500000,0,0,2009,0,thecryoftheowl20091127,the cry of the owl2009
64,2009-10-09,st. trinianâs,11400000,15000,29830239,2009,29815239,sttrinianâs20091009,st. trinianâs2009
68,2010-12-10,the fighter,11000000,93617009,129262388,2010,35645379,thefighter20101210,the fighter2010
69,2008-10-24,high school musical 3: senior year,11000000,90559416,274392880,2008,183833464,highschoolmusical3senioryear20081024,high school musical 3: senior year2008
71,2006-09-22,jackass: number two,11000000,72778712,85278712,2006,12500000,jackassnumbertwo20060922,jackass: number two2006
73,2014-08-22,if i stay,11000000,50474843,78356170,2014,27881327,ifistay20140822,if i stay2014
75,2003-04-04,phone booth,11000000,46566212,97837138,2003,51270926,phonebooth20030404,phone booth2003
76,2002-01-25,a walk to remember,11000000,41227069,46060861,2002,4833792,awalktoremember20020125,a walk to remember2002
79,2015-11-04,brooklyn,11000000,38322743,62076141,2015,23753398,brooklyn20151104,brooklyn2015
80,2008-10-17,the secret life of bees,11000000,37780486,39994347,2008,2213861,thesecretlifeofbees20081017,the secret life of bees2008
81,2015-04-01,woman in gold,11000000,33307793,58586407,2015,25278614,womaningold20150401,woman in gold2015
83,2017-12-08,"i, tonya",11000000,30014534,53797409,2017,23782875,itonya20171208,"i, tonya2017"
84,2009-10-23,saw vi,11000000,27693292,69752402,2009,42059110,sawvi20091023,saw vi2009
85,2001-10-12,corky romano,11000000,23978402,25116103,2001,1137701,corkyromano20011012,corky romano2001
86,2019-02-14,fighting with my family,11000000,22958583,39049922,2019,16091339,fightingwithmyfamily20190214,fighting with my family2019
90,2013-01-11,quartet,11000000,18388357,56178935,2013,37790578,quartet20130111,quartet2013
91,2001-11-21,out cold,11000000,13906394,14786394,2001,880000,outcold20011121,out cold2001
92,2000-10-13,the ladies man,11000000,13592872,13719474,2000,126602,theladiesman20001013,the ladies man2000
93,2001-03-30,tomcats,11000000,13558739,13558739,2001,0,tomcats20010330,tomcats2001
94,2013-12-06,inside llewyn davis,11000000,13248209,32943247,2013,19695038,insidellewyndavis20131206,inside llewyn davis2013
95,2002-04-12,frailty,11000000,13110448,19947280,2002,6836832,frailty20020412,frailty2002
97,2004-11-12,kinsey,11000000,10214647,17443529,2004,7228882,kinsey20041112,kinsey2004
98,2013-05-10,peeples,11000000,9177065,9307166,2013,130101,peeples20130510,peeples2013
100,2016-07-06,sultan,11000000,5599781,72989781,2016,67390000,sultan20160706,sultan2016
1,2002-02-01,slackers,11000000,4814244,5942218,2002,1127974,slackers20020201,slackers2002
2,2003-09-26,the gospel of john,11000000,4068087,4234355,2003,166268,thegospelofjohn20030926,the gospel of john2003
3,2004-10-10,vera drake,11000000,3753806,13353855,2004,9600049,veradrake20041010,vera drake2004
4,2003-01-31,the guru,11000000,3051221,24150550,2003,21099329,theguru20030131,the guru2003
9,2007-09-07,romance and cigarettes,11000000,551002,3231251,2007,2680249,romanceandcigarettes20070907,romance and cigarettes2007
10,2006-11-10,copying beethoven,11000000,355968,6586324,2006,6230356,copyingbeethoven20061110,copying beethoven2006
11,2011-08-26,brighton rock,11000000,229653,229653,2011,0,brightonrock20110826,brighton rock2011
12,2012-11-16,le prã©nom,11000000,61611,25307405,2012,25245794,leprãnom20121116,le prã©nom2012
13,2015-05-08,la famille bã©lier,11000000,0,82438670,2015,82438670,lafamillebãlier20150508,la famille bã©lier2015
14,2012-05-04,lol,11000000,0,10431506,2012,10431506,lol20120504,lol2012
15,2016-02-05,misconduct,11000000,0,2352511,2016,2352511,misconduct20160205,misconduct2016
16,2019-12-31,eli,11000000,0,0,2019,0,eli20191231,eli2019
17,2008-10-24,saw v,10800000,56746769,118209778,2008,61463009,sawv20081024,saw v2008
18,2012-05-25,les intouchables,10800000,13182281,484873045,2012,471690764,lesintouchables20120525,les intouchables2012
19,2007-04-27,jindabyne,10800000,399879,2862544,2007,2462665,jindabyne20070427,jindabyne2007
20,2006-08-11,kabhi alvida naa kehna,10750000,3275443,32575443,2006,29300000,kabhialvidanaakehna20060811,kabhi alvida naa kehna2006
24,2004-12-25,darkness,10600000,22163442,34409206,2004,12245764,darkness20041225,darkness2004
25,2013-12-06,the last days on mars,10600000,24084,261364,2013,237280,thelastdaysonmars20131206,the last days on mars2013
28,2007-04-20,in the land of women,10500000,11052958,14140402,2007,3087444,inthelandofwomen20070420,in the land of women2007
30,2004-02-20,the blue butterfly,10400000,1610194,1610194,2004,0,thebluebutterfly20040220,the blue butterfly2004
31,2001-11-02,le fabuleux destin d'amã©lie poulain,10350000,33201661,174201661,2001,141000000,lefabuleuxdestindamãliepoulain20011102,le fabuleux destin d'amã©lie poulain2001
32,2019-01-04,pmc: deo beong-keo,10300000,0,12478635,2019,12478635,pmcdeobeongkeo20190104,pmc: deo beong-keo2019
34,2010-04-30,housefull,10100000,1183658,18726300,2010,17542642,housefull20100430,housefull2010
35,2007-08-24,september dawn,10100000,1066555,1066555,2007,0,septemberdawn20070824,september dawn2007
36,2018-10-19,halloween,10000000,159342015,254900667,2018,95558652,halloween20181019,halloween2018
38,2004-10-22,the grudge,10000000,110359362,187281115,2004,76921753,thegrudge20041022,the grudge2004
39,2016-08-26,donât breathe,10000000,89217875,158973685,2016,69755810,donâtbreathe20160826,donât breathe2016
41,2006-10-27,saw iii,10000000,80238724,163876815,2006,83638091,sawiii20061027,saw iii2006
42,2016-07-01,the purge: election year,10000000,79042440,118514727,2016,39472287,thepurgeelectionyear20160701,the purge: election year2016
43,2018-05-18,book club,10000000,68566296,91113683,2018,22547387,bookclub20180518,book club2018
44,2000-08-25,bring it on,10000000,68353550,90453550,2000,22100000,bringiton20000825,bring it on2000
45,2018-01-05,insidious: the last key,10000000,67745330,167885588,2018,100140258,insidiousthelastkey20180105,insidious: the last key2018
47,2007-10-26,saw iv,10000000,63300095,135759694,2007,72459599,sawiv20071026,saw iv2007
48,2006-02-24,madea's family reunion,10000000,63257940,63320521,2006,62581,madeasfamilyreunion20060224,madea's family reunion2006
49,2005-01-07,white noise,10000000,56094360,92094360,2005,36000000,whitenoise20050107,white noise2005
51,2015-06-05,insidious chapter 3,10000000,52218558,120453155,2015,68234597,insidiouschapter320150605,insidious chapter 32015
53,2017-11-03,lady bird,10000000,48958273,78610769,2017,29652496,ladybird20171103,lady bird2017
54,2009-11-06,precious (based on the novel push by sapphire),10000000,47566524,68722848,2009,21156324,preciousbasedonthenovelpushbysapphire20091106,precious (based on the novel push by sapphire)2009
55,2012-05-04,the best exotic marigold hotel,10000000,46383639,134639780,2012,88256141,thebestexoticmarigoldhotel20120504,the best exotic marigold hotel2012
56,2018-06-08,hereditary,10000000,44069456,70133905,2018,26064449,hereditary20180608,hereditary2018
57,2018-03-16,"love, simon",10000000,40826341,65520633,2018,24694292,lovesimon20180316,"love, simon2018"
61,2017-10-27,jigsaw,10000000,38052832,102445196,2017,64392364,jigsaw20171027,jigsaw2017
62,2001-08-31,jeepers creepers,10000000,37904175,58939035,2001,21034860,jeeperscreepers20010831,jeepers creepers2001
65,2001-02-16,recess: school's out,10000000,36696761,44451470,2001,7754709,recessschoolsout20010216,recess: school's out2001
68,2016-01-22,the boy,10000000,35819556,68220952,2016,32401396,theboy20160122,the boy2016
70,2017-05-19,"everything, everything",10000000,34121140,61603136,2017,27481996,everythingeverything20170519,"everything, everything2017"
71,2010-09-17,devil,10000000,33679655,63354114,2010,29674459,devil20100917,devil2010
72,2002-11-22,friday after next,10000000,33253609,33526835,2002,273226,fridayafternext20021122,friday after next2002
73,2015-03-06,the second best exotic marigold hotel,10000000,33078266,90384306,2015,57306040,thesecondbestexoticmarigoldhotel20150306,the second best exotic marigold hotel2015
75,2017-04-28,how to be a latin lover,10000000,32149404,62556228,2017,30406824,howtobealatinlover20170428,how to be a latin lover2017
77,2008-10-03,nick and norah's infinite playlist,10000000,31487293,33886017,2008,2398724,nickandnorahsinfiniteplaylist20081003,nick and norah's infinite playlist2008
78,2003-12-19,calendar girls,10000000,31011616,93074616,2003,62063000,calendargirls20031219,calendar girls2003
80,2018-08-10,slender man,10000000,30564825,51723644,2018,21158819,slenderman20180810,slender man2018
81,2002-09-20,the banger sisters,10000000,30306281,38067218,2002,7760937,thebangersisters20020920,the banger sisters2002
82,2000-12-08,snatch,10000000,30093107,83593107,2000,53500000,snatch20001208,snatch2000
84,2018-07-27,teen titans go! to the movies,10000000,29790236,51620593,2018,21830357,teentitansgotothemovies20180727,teen titans go! to the movies2018
85,2016-09-09,when the bough breaks,10000000,29747603,30768449,2016,1020846,whentheboughbreaks20160909,when the bough breaks2016
88,2013-08-30,one direction: this is us,10000000,28873374,68541786,2013,39668412,onedirectionthisisus20130830,one direction: this is us2013
89,2002-09-06,swimfan,10000000,28564995,34084228,2002,5519233,swimfan20020906,swimfan2002
90,2006-10-06,employee of the month,10000000,28444855,38364855,2006,9920000,employeeofthemonth20061006,employee of the month2006
91,2015-08-21,sinister 2,10000000,27740955,54104225,2015,26363270,sinister220150821,sinister 22015
92,2016-01-08,the forest,10000000,26594261,40749230,2016,14154969,theforest20160108,the forest2016
93,2009-11-06,the fourth kind,10000000,26218170,49486874,2009,23268704,thefourthkind20091106,the fourth kind2009
96,2012-08-17,sparkle,10000000,24397469,24660323,2012,262854,sparkle20120817,sparkle2012
97,2016-10-14,kevin hart: what now?,10000000,23591043,23591043,2016,0,kevinhartwhatnow20161014,kevin hart: what now?2016
98,2013-04-26,mud,10000000,21590086,31556959,2013,9966873,mud20130426,mud2013
99,2010-11-12,skyline,10000000,21416355,68264973,2010,46848618,skyline20101112,skyline2010
100,2017-12-01,the disaster artist,10000000,21120616,28717667,2017,7597051,thedisasterartist20171201,the disaster artist2017
1,2016-09-16,blair witch,10000000,20777061,38985577,2016,18208516,blairwitch20160916,blair witch2016
3,2001-02-02,valentine,10000000,20384136,20384136,2001,0,valentine20010202,valentine2001
4,2006-06-09,a prairie home companion,10000000,20342852,26716191,2006,6373339,aprairiehomecompanion20060609,a prairie home companion2006
5,2007-02-23,reno 911!: miami,10000000,20342161,21851362,2007,1509201,reno911miami20070223,reno 911!: miami2007
7,2015-10-23,paranormal activity: the ghost dimension,10000000,18297124,77959374,2015,59662250,paranormalactivitytheghostdimension20151023,paranormal activity: the ghost dimension2015
9,2008-06-20,kit kittredge: an american girl,10000000,17657973,17657973,2008,0,kitkittredgeanamericangirl20080620,kit kittredge: an american girl2008
11,2005-09-23,roll bounce,10000000,17380866,17433072,2005,52206,rollbounce20050923,roll bounce2005
14,2005-06-17,the perfect man,10000000,16535005,19535005,2005,3000000,theperfectman20050617,the perfect man2005
16,2002-01-25,kung pow: enter the fist,10000000,16033556,17033556,2002,1000000,kungpowenterthefist20020125,kung pow: enter the fist2002
17,2016-10-07,the birth of a nation,10000000,15861566,16891011,2016,1029445,thebirthofanation20161007,the birth of a nation2016
18,2003-05-30,wrong turn,10000000,15417771,28649556,2003,13231785,wrongturn20030530,wrong turn2003
21,2009-08-14,"the goods: live hard, sell hard",10000000,15122676,15297318,2009,174642,thegoodslivehardsellhard20090814,"the goods: live hard, sell hard2009"
22,2011-11-23,my week with marilyn,10000000,14597405,34240572,2011,19643167,myweekwithmarilyn20111123,my week with marilyn2011
23,2014-12-25,big eyes,10000000,14482031,27317872,2014,12835841,bigeyes20141225,big eyes2014
24,2005-08-05,broken flowers,10000000,13744960,40744960,2005,27000000,brokenflowers20050805,broken flowers2005
25,2002-06-28,hey arnold! the movie,10000000,13684949,13684949,2002,0,heyarnoldthemovie20020628,hey arnold! the movie2002
26,2005-12-30,the matador,10000000,12589255,17300838,2005,4711583,thematador20051230,the matador2005
28,2000-12-19,the gift,10000000,12008642,44567606,2000,32558964,thegift20001219,the gift2000
29,2006-01-20,end of the spear,10000000,11748661,11924041,2006,175380,endofthespear20060120,end of the spear2006
30,2001-03-09,get over it,10000000,11560259,19860259,2001,8300000,getoverit20010309,get over it2001
31,2000-10-20,the legend of drunken master,10000000,11546543,11546543,2000,0,thelegendofdrunkenmaster20001020,the legend of drunken master2000
34,2019-04-05,the best of enemies,10000000,10205616,10205616,2019,0,thebestofenemies20190405,the best of enemies2019
38,2004-07-09,sleepover,10000000,9408183,9408183,2004,0,sleepover20040709,sleepover2004
39,2013-01-25,movie 43,10000000,8840453,31164747,2013,22324294,movie4320130125,movie 432013
40,2018-10-19,can you ever forgive me?,10000000,8803865,11752387,2018,2948522,canyoueverforgiveme20181019,can you ever forgive me?2018
42,2010-05-21,macgruber,10000000,8525600,8629895,2010,104295,macgruber20100521,macgruber2010
43,2003-07-18,dirty pretty things,10000000,8112414,14156753,2003,6044339,dirtyprettythings20030718,dirty pretty things2003
44,2014-03-14,bad words,10000000,7779614,7843145,2014,63531,badwords20140314,bad words2014
45,2015-03-27,while we're young,10000000,7582065,17503828,2015,9921763,whilewereyoung20150327,while we're young2015
46,2008-02-01,over her dead body,10000000,7570127,21596074,2008,14025947,overherdeadbody20080201,over her dead body2008
47,2001-10-24,bones,10000000,7316658,8378853,2001,1062195,bones20011024,bones2001
48,2012-06-22,seeking a friend for the end of the world,10000000,7078738,11766959,2012,4688221,seekingafriendfortheendoftheworld20120622,seeking a friend for the end of the world2012
49,2006-12-01,turistas,10000000,7027762,14321070,2006,7293308,turistas20061201,turistas2006
50,2016-11-11,shut in,10000000,6900335,11360665,2016,4460330,shutin20161111,shut in2016
51,2011-02-11,cedar rapids,10000000,6861102,7862131,2011,1001029,cedarrapids20110211,cedar rapids2011
52,2012-11-30,the collection,10000000,6810754,8890094,2012,2079340,thecollection20121130,the collection2012
54,2004-01-16,teacher's pet: the movie,10000000,6491969,6491969,2004,0,teacherspetthemovie20040116,teacher's pet: the movie2004
56,2002-05-03,deuces wild,10000000,6044618,6244618,2002,200000,deuceswild20020503,deuces wild2002
57,2008-03-28,"run, fatboy, run",10000000,6003262,33512260,2008,27508998,runfatboyrun20080328,"run, fatboy, run2008"
59,2015-03-20,danny collins,10000000,5637066,8465845,2015,2828779,dannycollins20150320,danny collins2015
60,2007-07-04,rescue dawn,10000000,5490423,7037886,2007,1547463,rescuedawn20070704,rescue dawn2007
61,2000-04-05,black and white,10000000,5241315,5241315,2000,0,blackandwhite20000405,black and white2000
62,2010-06-18,io sono lâamore,10000000,5005465,15121528,2010,10116063,iosonolâamore20100618,io sono lâamore2010
63,2001-10-26,on the line,10000000,4365455,4690802,2001,325347,ontheline20011026,on the line2001
64,2018-06-15,gotti,10000000,4286367,6089100,2018,1802733,gotti20180615,gotti2018
65,2012-03-16,"jeff, who lives at home",10000000,4269426,4708127,2012,438701,jeffwholivesathome20120316,"jeff, who lives at home2012"
66,2016-09-30,denial,10000000,4073448,9263940,2016,5190492,denial20160930,denial2016
67,2016-04-29,the man who knew infinity,10000000,3877922,12382122,2016,8504200,themanwhoknewinfinity20160429,the man who knew infinity2016
68,2016-10-14,max steel,10000000,3818664,4563080,2016,744416,maxsteel20161014,max steel2016
69,2016-03-30,everybody wants some,10000000,3400278,5437126,2016,2036848,everybodywantssome20160330,everybody wants some2016
71,2012-10-12,atlas shrugged: part ii,10000000,3336053,3336053,2012,0,atlasshruggedpartii20121012,atlas shrugged: part ii2012
74,2014-11-14,rosewater,10000000,3128941,3185717,2014,56776,rosewater20141114,rosewater2014
75,2000-12-22,the house of mirth,10000000,3041803,5149131,2000,2107328,thehouseofmirth20001222,the house of mirth2000
77,2006-06-02,peaceful warrior,10000000,2893666,3260179,2006,366513,peacefulwarrior20060602,peaceful warrior2006
78,2011-09-09,bucky larson: born to be a star,10000000,2529395,2529395,2011,0,buckylarsonborntobeastar20110909,bucky larson: born to be a star2011
79,2000-10-06,bamboozled,10000000,2185266,2373937,2000,188671,bamboozled20001006,bamboozled2000
81,2013-05-03,the iceman,10000000,1930282,3623609,2013,1693327,theiceman20130503,the iceman2013
82,2015-06-05,testament of youth,10000000,1822250,6646669,2015,4824419,testamentofyouth20150605,testament of youth2015
83,2017-04-21,free fire,10000000,1799322,3793739,2017,1994417,freefire20170421,free fire2017
84,2011-06-24,a better life,10000000,1759252,1884251,2011,124999,abetterlife20110624,a better life2011
85,2003-02-28,spider,10000000,1641788,1641788,2003,0,spider20030228,spider2003
86,2000-02-04,gun shy,10000000,1638202,1638202,2000,0,gunshy20000204,gun shy2000
87,2002-12-27,nicholas nickleby,10000000,1562800,1562800,2002,0,nicholasnickleby20021227,nicholas nickleby2002
88,2010-04-16,the joneses,10000000,1475746,3541565,2010,2065819,thejoneses20100416,the joneses2010
89,2006-06-23,krrish,10000000,1430721,32430721,2006,31000000,krrish20060623,krrish2006
90,2012-07-27,killer joe,10000000,1291645,4659110,2012,3367465,killerjoe20120727,killer joe2012
91,2017-06-02,churchill,10000000,1279681,7582196,2017,6302515,churchill20170602,churchill2017
92,2000-08-11,cecil b. demented,10000000,1276984,1953882,2000,676898,cecilbdemented20000811,cecil b. demented2000
93,2014-03-21,50 to 1,10000000,1069454,1069454,2014,0,50to120140321,50 to 12014
94,2003-05-02,owning mahowny,10000000,1011054,1011054,2003,0,owningmahowny20030502,owning mahowny2003
95,2007-10-19,the ten commandments,10000000,952820,1051907,2007,99087,thetencommandments20071019,the ten commandments2007
96,2007-09-07,the brothers solomon,10000000,900926,900926,2007,0,thebrotherssolomon20070907,the brothers solomon2007
97,2008-04-04,my blueberry nights,10000000,866778,22198996,2008,21332218,myblueberrynights20080404,my blueberry nights2008
99,2012-01-20,coriolanus,10000000,749641,2179623,2012,1429982,coriolanus20120120,coriolanus2012
100,2013-10-04,parkland,10000000,641439,1616353,2013,974914,parkland20131004,parkland2013
1,2002-10-11,swept away,10000000,598645,598645,2002,0,sweptaway20021011,swept away2002
2,2008-05-23,"war, inc.",10000000,580862,1299855,2008,718993,warinc20080523,"war, inc.2008"
3,2004-04-02,shaolin soccer,10000000,488872,42776032,2004,42287160,shaolinsoccer20040402,shaolin soccer2004
4,2004-08-27,the brown bunny,10000000,366301,630427,2004,264126,thebrownbunny20040827,the brown bunny2004
5,2007-09-14,king of california,10000000,268461,1165102,2007,896641,kingofcalifornia20070914,king of california2007
8,2004-12-17,imaginary heroes,10000000,228524,290875,2004,62351,imaginaryheroes20041217,imaginary heroes2004
9,2001-10-26,high heels and low lifes,10000000,226792,226792,2001,0,highheelsandlowlifes20011026,high heels and low lifes2001
10,2009-08-21,world's greatest dad,10000000,221805,295750,2009,73945,worldsgreatestdad20090821,world's greatest dad2009
11,2013-05-03,"cinco de mayo, la batalla",10000000,173472,173472,2013,0,cincodemayolabatalla20130503,"cinco de mayo, la batalla2013"
12,2010-10-29,welcome to the rileys,10000000,152857,355919,2010,203062,welcometotherileys20101029,welcome to the rileys2010
13,2016-09-09,kicks,10000000,150191,150191,2016,0,kicks20160909,kicks2016
14,2009-10-09,free style,10000000,141108,721108,2009,580000,freestyle20091009,free style2009
15,2012-06-01,high school,10000000,139034,248133,2012,109099,highschool20120601,high school2012
16,2007-05-18,severance,10000000,137221,5950002,2007,5812781,severance20070518,severance2007
17,2006-07-14,edmond,10000000,131719,241719,2006,110000,edmond20060714,edmond2006
18,2010-04-23,joheunnom nabbeunnom isanghannom,10000000,128486,42226657,2010,42098171,joheunnomnabbeunnomisanghannom20100423,joheunnom nabbeunnom isanghannom2010
20,2010-02-19,blood done sign my name,10000000,109383,109383,2010,0,blooddonesignmyname20100219,blood done sign my name2010
21,2010-02-19,the good guy,10000000,100688,106460,2010,5772,thegoodguy20100219,the good guy2010
22,2009-10-23,motherhood,10000000,93388,723388,2009,630000,motherhood20091023,motherhood2009
23,2004-10-15,eulogy,10000000,70527,70527,2004,0,eulogy20041015,eulogy2004
24,2014-11-07,elsa & fred,10000000,67657,197901,2014,130244,elsafred20141107,elsa & fred2014
26,2009-08-28,the open road,10000000,19716,19716,2009,0,theopenroad20090828,the open road2009
27,2015-07-10,strangerland,10000000,17472,161097,2015,143625,strangerland20150710,strangerland2015
28,2015-03-13,hross i oss,10000000,11894,11894,2015,0,hrossioss20150313,hross i oss2015
29,2009-10-16,janky promoters,10000000,9069,9069,2009,0,jankypromoters20091016,janky promoters2009
30,2007-12-21,blonde ambition,10000000,6422,1537479,2007,1531057,blondeambition20071221,blonde ambition2007
31,2010-08-06,the oxford murders,10000000,4803,17704131,2010,17699328,theoxfordmurders20100806,the oxford murders2010
32,2014-12-26,barbecue,10000000,388,247565,2014,247177,barbecue20141226,barbecue2014
33,2010-12-31,the reef,10000000,0,15037867,2010,15037867,thereef20101231,the reef2010
34,2008-01-08,white noise 2: the light,10000000,0,8243567,2008,8243567,whitenoise2thelight20080108,white noise 2: the light2008
35,2015-07-21,american heist,10000000,0,2341218,2015,2341218,americanheist20150721,american heist2015
36,2010-10-08,it's a wonderful afterlife,10000000,0,1642939,2010,1642939,itsawonderfulafterlife20101008,it's a wonderful afterlife2010
37,2011-06-21,you got served: beat the world,10000000,0,1230542,2011,1230542,yougotservedbeattheworld20110621,you got served: beat the world2011
38,2009-08-21,fifty dead men walking,10000000,0,997921,2009,997921,fiftydeadmenwalking20090821,fifty dead men walking2009
39,2014-09-26,plastic,10000000,0,575371,2014,575371,plastic20140926,plastic2014
40,2015-03-10,jungle shuffle,10000000,0,360898,2015,360898,jungleshuffle20150310,jungle shuffle2015
41,2009-09-22,adam resurrected,10000000,0,90909,2009,90909,adamresurrected20090922,adam resurrected2009
42,2009-05-26,the devil's tomb,10000000,0,0,2009,0,thedevilstomb20090526,the devil's tomb2009
43,2009-12-31,good intentions,10000000,0,0,2009,0,goodintentions20091231,good intentions2009
44,2007-02-02,partition,10000000,0,0,2007,0,partition20070202,partition2007
45,2012-04-13,detention,10000000,0,0,2012,0,detention20120413,detention2012
46,2014-02-07,nurse 3d,10000000,0,0,2014,0,nurse3d20140207,nurse 3d2014
47,2015-05-19,into the grizzly maze,10000000,0,0,2015,0,intothegrizzlymaze20150519,into the grizzly maze2015
48,2017-09-22,friend request,9900000,3759078,11310835,2017,7551757,friendrequest20170922,friend request2017
49,2010-04-30,gunless,9900000,458054,458054,2010,0,gunless20100430,gunless2010
50,2009-04-03,adventureland,9800000,16044025,17553055,2009,1509030,adventureland20090403,adventureland2009
51,2012-12-19,amour,9700000,6738954,36787044,2012,30048090,amour20121219,amour2012
52,2006-04-28,the lost city,9600000,2484186,5256839,2006,2772653,thelostcity20060428,the lost city2006
53,2000-01-12,next friday,9500000,57176582,59675307,2000,2498725,nextfriday20000112,next friday2000
56,2016-12-21,dangal,9500000,12391761,294654618,2016,282262857,dangal20161221,dangal2016
57,2010-03-19,the runaways,9500000,3573673,5278632,2010,1704959,therunaways20100319,the runaways2010
58,2009-10-30,gentlemen broncos,9500000,115155,119955,2009,4800,gentlemenbroncos20091030,gentlemen broncos2009
59,2013-12-31,re-kill,9500000,0,0,2013,0,rekill20131231,re-kill2013
61,2006-11-03,volver,9400000,12899867,87226613,2006,74326746,volver20061103,volver2006
62,2011-11-11,melancholia,9400000,3030848,21817298,2011,18786450,melancholia20111111,melancholia2011
64,2012-11-13,jab tak hai jaan,9200000,3047539,5806666,2012,2759127,jabtakhaijaan20121113,jab tak hai jaan2012
66,2010-05-21,kites,9200000,1685269,17155193,2010,15469924,kites20100521,kites2010
67,2011-12-31,red dog,9100000,0,20927794,2011,20927794,reddog20111231,red dog2011
68,2010-12-31,mine vaganti,9100000,0,18872126,2010,18872126,minevaganti20101231,mine vaganti2010
69,2003-10-17,the texas chainsaw massacre,9000000,80571655,107967319,2003,27395664,thetexaschainsawmassacre20031017,the texas chainsaw massacre2003
71,2014-07-18,the purge: anarchy,9000000,71562550,111534881,2014,39972331,thepurgeanarchy20140718,the purge: anarchy2014
73,2008-05-30,the strangers,9000000,52597610,83051676,2008,30454066,thestrangers20080530,the strangers2008
75,2016-10-21,ouija: origin of evil,9000000,35144505,81831866,2016,46687361,ouijaoriginofevil20161021,ouija: origin of evil2016
78,2019-02-13,happy death day 2u,9000000,28051045,64179495,2019,36128450,happydeathday2u20190213,happy death day 2u2019
79,2007-06-22,sicko,9000000,24538513,36535837,2007,11997324,sicko20070622,sicko2007
80,2015-01-30,black or white,9000000,21571189,21971021,2015,399832,blackorwhite20150130,black or white2015
81,2000-01-21,down to you,9000000,20035310,20035310,2000,0,downtoyou20000121,down to you2000
82,2004-07-30,harold & kumar go to white castle,9000000,18225165,18225165,2004,0,haroldkumargotowhitecastle20040730,harold & kumar go to white castle2004
83,2000-10-13,the contender,9000000,17804273,17804273,2000,0,thecontender20001013,the contender2000
84,2000-02-18,boiler room,9000000,16963963,28773637,2000,11809674,boilerroom20000218,boiler room2000
85,2006-12-05,black christmas,9000000,16235738,16235738,2006,0,blackchristmas20061205,black christmas2006
86,2016-11-18,the edge of seventeen,9000000,14431633,19096003,2016,4664370,theedgeofseventeen20161118,the edge of seventeen2016
87,2016-12-02,jackie,9000000,13960394,36588512,2016,22628118,jackie20161202,jackie2016
89,2004-05-14,breakin' all the rules,9000000,12232382,12512317,2004,279935,breakinalltherules20040514,breakin' all the rules2004
90,2011-08-12,glee: the 3d concert movie,9000000,11862398,17462398,2011,5600000,gleethe3dconcertmovie20110812,glee: the 3d concert movie2011
92,2016-11-04,loving,9000000,7710234,12898064,2016,5187830,loving20161104,loving2016
93,2007-11-28,the savages,9000000,6623082,10642023,2007,4018941,thesavages20071128,the savages2007
94,2003-04-16,chasing papi,9000000,6126237,12657377,2003,6531140,chasingpapi20030416,chasing papi2003
95,2000-09-08,the way of the gun,9000000,6047856,13061935,2000,7014079,thewayofthegun20000908,the way of the gun2000
96,2019-05-17,the sun is also a star,9000000,4950029,5434029,2019,484000,thesunisalsoastar20190517,the sun is also a star2019
97,2008-08-22,hamlet 2,9000000,4886216,4934104,2008,47888,hamlet220080822,hamlet 22008
98,2002-09-13,igby goes down,9000000,4777465,4777465,2002,0,igbygoesdown20020913,igby goes down2002
100,2007-03-09,the ultimate gift,9000000,3438735,3438735,2007,0,theultimategift20070309,the ultimate gift2007
1,2000-09-29,beautiful,9000000,3134509,3134509,2000,0,beautiful20000929,beautiful2000
2,2007-06-01,gracie,9000000,2956339,3922043,2007,965704,gracie20070601,gracie2007
3,2013-03-22,the sapphires,9000000,2450867,20395040,2013,17944173,thesapphires20130322,the sapphires2013
4,2016-08-26,greater,9000000,2000093,2000093,2016,0,greater20160826,greater2016
5,2018-12-25,destroyer,9000000,1533324,3681096,2018,2147772,destroyer20181225,destroyer2018
6,2006-08-18,trust the man,9000000,1530535,2548378,2006,1017843,trusttheman20060818,trust the man2006
7,2005-08-26,undiscovered,9000000,1069318,1069318,2005,0,undiscovered20050826,undiscovered2005
9,2010-05-14,princess kaiulani,9000000,883887,883887,2010,0,princesskaiulani20100514,princess kaiulani2010
10,2003-06-20,the legend of suriyothai,9000000,454255,454255,2003,0,thelegendofsuriyothai20030620,the legend of suriyothai2003
12,2016-05-06,dheepan,9000000,248795,7704357,2016,7455562,dheepan20160506,dheepan2016
13,2010-01-22,la fille du rer,9000000,208163,208163,2010,0,lafilledurer20100122,la fille du rer2010
14,2002-10-25,all or nothing,9000000,184255,184255,2002,0,allornothing20021025,all or nothing2002
15,2010-02-05,red riding: the year of our lord 1974,9000000,148826,148826,2010,0,redridingtheyearofourlord197420100205,red riding: the year of our lord 19742010
16,2009-07-31,flammen og citronen,9000000,148089,1635241,2009,1487152,flammenogcitronen20090731,flammen og citronen2009
17,2010-04-02,leaves of grass,9000000,70066,85527,2010,15461,leavesofgrass20100402,leaves of grass2010
18,2006-11-22,opal dream,9000000,14443,14443,2006,0,opaldream20061122,opal dream2006
19,2015-05-08,skin trade,9000000,1242,1242,2015,0,skintrade20150508,skin trade2015
20,2014-06-17,beneath hill 60,9000000,0,3440939,2014,3440939,beneathhill6020140617,beneath hill 602014
21,2015-01-20,veronika decides to die,9000000,0,2243,2015,2243,veronikadecidestodie20150120,veronika decides to die2015
23,2013-02-01,a haunting in connecticut 2: the ghosts of georgia,9000000,0,0,2013,0,ahauntinginconnecticut2theghostsofgeorgia20130201,a haunting in connecticut 2: the ghosts of georgia2013
24,2012-05-18,polisse,8900000,176988,22744132,2012,22567144,polisse20120518,polisse2012
25,2015-11-13,heist,8900000,50136,3324131,2015,3273995,heist20151113,heist2015
26,2011-02-26,ultramarines,8900000,0,0,2011,0,ultramarines20110226,ultramarines2011
28,2004-12-31,the i inside,8800000,0,0,2004,0,theiinside20041231,the i inside2004
29,2007-11-30,awake,8600000,14373825,32968648,2007,18594823,awake20071130,awake2007
30,2016-11-18,manchester by the sea,8500000,47695371,77733867,2016,30038496,manchesterbythesea20161118,manchester by the sea2016
31,2009-12-16,crazy heart,8500000,39471742,47417251,2009,7945509,crazyheart20091216,crazy heart2009
32,2008-08-15,star wars: the clone wars,8500000,35161554,68695443,2008,33533889,starwarstheclonewars20080815,star wars: the clone wars2008
33,2015-02-20,the duff,8500000,34030343,43528634,2015,9498291,theduff20150220,the duff2015
34,2014-10-31,nightcrawler,8500000,32381218,50334418,2014,17953200,nightcrawler20141031,nightcrawler2014
36,2019-01-16,dragon ball super: broly,8500000,30376755,122747755,2019,92371000,dragonballsuperbroly20190116,dragon ball super: broly2019
38,2013-09-27,baggage claim,8500000,21569509,22885836,2013,1316327,baggageclaim20130927,baggage claim2013
39,2016-10-07,middle school: the worst years of my life,8500000,20007149,23311293,2016,3304144,middleschooltheworstyearsofmylife20161007,middle school: the worst years of my life2016
42,2007-03-09,the namesake,8500000,13610521,20288774,2007,6678253,thenamesake20070309,the namesake2007
43,2013-10-18,all is lost,8500000,6263670,10386814,2013,4123144,allislost20131018,all is lost2013
44,2004-02-27,club dread,8500000,5001655,7573551,2004,2571896,clubdread20040227,club dread2004
45,2009-09-17,bright star,8500000,4444637,17220091,2009,12775454,brightstar20090917,bright star2009
46,2001-09-21,glitter,8500000,4273372,4273372,2001,0,glitter20010921,glitter2001
47,2014-06-13,the rover,8500000,1109199,3180252,2014,2071053,therover20140613,the rover2014
48,2004-04-23,silmido,8500000,298347,30298347,2004,30000000,silmido20040423,silmido2004
49,2008-11-07,repo! the genetic opera,8500000,140244,198883,2008,58639,repothegeneticopera20081107,repo! the genetic opera2008
50,2017-12-31,posledniy bogatyr,8500000,0,30700192,2017,30700192,posledniybogatyr20171231,posledniy bogatyr2017
51,2016-11-01,a.c.o.r.n.s.: operation crackdown,8500000,0,1353287,2016,1353287,acornsoperationcrackdown20161101,a.c.o.r.n.s.: operation crackdown2016
52,2010-02-12,my name is khan,8470000,4046336,42355526,2010,38309190,mynameiskhan20100212,my name is khan2010
53,2007-03-23,namastey london,8400000,1207007,6831069,2007,5624062,namasteylondon20070323,namastey london2007
54,2013-05-31,yeh jawaani hai deewani,8300000,3827466,50827466,2013,47000000,yehjawaanihaideewani20130531,yeh jawaani hai deewani2013
56,2007-03-16,the wind that shakes the barley,8300000,1829142,25670174,2007,23841032,thewindthatshakesthebarley20070316,the wind that shakes the barley2007
57,2010-04-16,the city of your final destination,8300000,493296,1353296,2010,860000,thecityofyourfinaldestination20100416,the city of your final destination2010
58,2006-11-24,kurtlar vadisi - irak,8300000,0,24906717,2006,24906717,kurtlarvadisiirak20061124,kurtlar vadisi - irak2006
66,2006-07-26,little miss sunshine,8000000,59891098,100642353,2006,40751255,littlemisssunshine20060726,little miss sunshine2006
67,2010-09-17,easy a,8000000,58401464,76200721,2010,17799257,easya20100917,easy a2010
69,2003-06-27,28 days laterâ¦,8000000,45064915,82955633,2003,37890718,28dayslaterâ20030627,28 days laterâ¦2003
71,2004-01-30,you got served,8000000,40066497,50811858,2004,10745361,yougotserved20040130,you got served2004
72,2019-05-03,the intruder,8000000,35095904,36005871,2019,909967,theintruder20190503,the intruder2019
73,2011-09-30,50/50,8000000,35016118,41334735,2011,6318617,505020110930,50/502011
75,2015-09-02,a walk in the woods,8000000,29499394,37119358,2015,7619964,awalkinthewoods20150902,a walk in the woods2015
76,2002-10-11,brown sugar,8000000,27362712,28315272,2002,952560,brownsugar20021011,brown sugar2002
78,2014-01-31,that awkward moment,8000000,26068955,53068955,2014,27000000,thatawkwardmoment20140131,that awkward moment2014
79,2008-03-21,shutter,8000000,25928550,47782426,2008,21853876,shutter20080321,shutter2008
85,2006-04-28,akeelah and the bee,8000000,18848430,18959424,2006,110994,akeelahandthebee20060428,akeelah and the bee2006
88,2013-09-18,enough said,8000000,17550872,25621449,2013,8070577,enoughsaid20130918,enough said2013
90,2009-01-30,new in town,8000000,16734283,29937909,2009,13203626,newintown20090130,new in town2009
91,2014-06-27,begin again,8000000,16170632,68838736,2014,52668104,beginagain20140627,begin again2014
92,2000-04-14,american psycho,8000000,15070285,34270285,2000,19200000,americanpsycho20000414,american psycho2000
93,2006-05-19,see no evil,8000000,15032800,18828036,2006,3795236,seenoevil20060519,see no evil2006
94,2002-08-07,the good girl,8000000,14018296,16585503,2002,2567207,thegoodgirl20020807,the good girl2002
95,2006-08-04,"bon cop, bad cop",8000000,12671300,12740705,2006,69405,boncopbadcop20060804,"bon cop, bad cop2006"
96,2009-10-30,the boondock saints 2: all saints day,8000000,10273187,10629320,2009,356133,theboondocksaints2allsaintsday20091030,the boondock saints 2: all saints day2009
97,2011-04-29,prom,8000000,10130219,10763183,2011,632964,prom20110429,prom2011
99,2000-12-29,shadow of the vampire,8000000,8279017,8279017,2000,0,shadowofthevampire20001229,shadow of the vampire2000
100,2015-06-12,me and earl and the dying girl,8000000,6758416,9266180,2015,2507764,meandearlandthedyinggirl20150612,me and earl and the dying girl2015
1,2010-10-08,it's kind of a funny story,8000000,6363628,6632950,2010,269322,itskindofafunnystory20101008,it's kind of a funny story2010
3,2000-09-22,woman on top,8000000,5018450,10192613,2000,5174163,womanontop20000922,woman on top2000
4,2000-05-12,held up,8000000,4714090,4714090,2000,0,heldup20000512,held up2000
5,2016-09-02,morgan,8000000,3915251,7298786,2016,3383535,morgan20160902,morgan2016
6,2015-12-30,anomalisa,8000000,3759286,5706168,2015,1946882,anomalisa20151230,anomalisa2015
7,2005-12-23,cachã©,8000000,3647381,19891331,2005,16243950,cachã20051223,cachã©2005
8,2010-12-29,another year,8000000,3205706,20005613,2010,16799907,anotheryear20101229,another year2010
9,2002-09-20,8 femmes,8000000,3076425,42376425,2002,39300000,8femmes20020920,8 femmes2002
12,2013-12-20,le passã©,8000000,1335672,15752575,2013,14416903,lepassã20131220,le passã©2013
13,2018-04-06,lean on pete,8000000,1163056,2455027,2018,1291971,leanonpete20180406,lean on pete2018
14,2010-11-19,made in dagenham,8000000,1095369,15644196,2010,14548827,madeindagenham20101119,made in dagenham2010
15,2008-06-06,and when did you last see your father?,8000000,1071240,2476491,2008,1405251,andwhendidyoulastseeyourfather20080606,and when did you last see your father?2008
16,2019-05-03,el chicano,8000000,700261,700261,2019,0,elchicano20190503,el chicano2019
17,2010-03-05,the secret of kells,8000000,690290,3582797,2010,2892507,thesecretofkells20100305,the secret of kells2010
20,2006-05-05,down in the valley,8000000,568932,973443,2006,404511,downinthevalley20060505,down in the valley2006
21,2007-05-11,brooklyn rules,8000000,458232,458232,2007,0,brooklynrules20070511,brooklyn rules2007
22,2003-10-24,the singing detective,8000000,336456,524747,2003,188291,thesingingdetective20031024,the singing detective2003
23,2007-06-15,fido,8000000,298110,456814,2007,158704,fido20070615,fido2007
24,2018-10-26,london fields,8000000,252676,433732,2018,181056,londonfields20181026,london fields2018
25,2011-09-16,restless,8000000,163753,2772511,2011,2608758,restless20110916,restless2011
27,2007-05-18,the wendell baker story,8000000,127188,127188,2007,0,thewendellbakerstory20070518,the wendell baker story2007
28,2010-10-29,wild target,8000000,109338,5314194,2010,5204856,wildtarget20101029,wild target2010
29,2008-04-18,pathology,8000000,109045,3270974,2008,3161929,pathology20080418,pathology2008
30,2012-10-05,wuthering heights,8000000,100915,2721534,2012,2620619,wutheringheights20121005,wuthering heights2012
31,2016-11-18,a street cat named bob,8000000,82703,17382693,2016,17299990,astreetcatnamedbob20161118,a street cat named bob2016
32,2006-08-18,10th & wolf,8000000,54702,143782,2006,89080,10thwolf20060818,10th & wolf2006
33,2015-05-22,aloft,8000000,53086,237688,2015,184602,aloft20150522,aloft2015
34,2011-10-14,fireflies in the garden,8000000,36884,3587191,2011,3550307,firefliesinthegarden20111014,fireflies in the garden2011
35,2005-09-23,dear wendy,8000000,23106,446438,2005,423332,dearwendy20050923,dear wendy2005
36,2001-04-27,akira,8000000,19585,19585,2001,0,akira20010427,akira2001
37,2005-12-31,welcome to dongmakgol,8000000,0,48000000,2005,48000000,welcometodongmakgol20051231,welcome to dongmakgol2005
38,2013-09-20,feichang xingyun,8000000,0,21970000,2013,21970000,feichangxingyun20130920,feichang xingyun2013
39,2017-09-29,"don gato, el inicio de la pandilla",8000000,0,4604656,2017,4604656,dongatoeliniciodelapandilla20170929,"don gato, el inicio de la pandilla2017"
40,2007-09-04,the death and life of bobby z,8000000,0,414617,2007,414617,thedeathandlifeofbobbyz20070904,the death and life of bobby z2007
41,2018-04-24,backstabbing for beginners,8000000,0,343773,2018,343773,backstabbingforbeginners20180424,backstabbing for beginners2018
42,2014-08-12,swelter,8000000,0,44197,2014,44197,swelter20140812,swelter2014
43,2007-11-30,maurice richard,8000000,0,0,2007,0,mauricerichard20071130,maurice richard2007
44,2015-02-24,green street hooligans: underground,8000000,0,0,2015,0,greenstreethooligansunderground20150224,green street hooligans: underground2015
45,2009-12-31,christmas in beverly hills,8000000,0,0,2009,0,christmasinbeverlyhills20091231,christmas in beverly hills2009
46,2015-12-31,henry joseph church,8000000,0,0,2015,0,henryjosephchurch20151231,henry joseph church2015
47,2016-05-06,code of honor,8000000,0,0,2016,0,codeofhonor20160506,code of honor2016
48,2019-06-21,burn your maps,8000000,0,0,2019,0,burnyourmaps20190621,burn your maps2019
49,2006-01-27,imagine me & you,7900000,672243,3129471,2006,2457228,imaginemeyou20060127,imagine me & you2006
50,2003-07-04,swimming pool,7800000,10130108,24021282,2003,13891174,swimmingpool20030704,swimming pool2003
52,2015-04-14,loin des hommes,7700000,5336,1080428,2015,1075092,loindeshommes20150414,loin des hommes2015
55,2009-07-17,(500) days of summer,7500000,32425665,34439060,2009,2013395,500daysofsummer20090717,(500) days of summer2009
57,2006-03-17,thank you for smoking,7500000,24793509,40016662,2006,15223153,thankyouforsmoking20060317,thank you for smoking2006
58,2007-06-08,hostel: part ii,7500000,17544812,33606409,2007,16061597,hostelpartii20070608,hostel: part ii2007
59,2009-10-09,an education,7500000,12574914,29652736,2009,17077822,aneducation20091009,an education2009
60,2009-09-04,extract,7500000,10823158,10849158,2009,26000,extract20090904,extract2009
61,2002-12-20,narc,7500000,10465659,11843260,2002,1377601,narc20021220,narc2002
62,2005-10-21,shopgirl,7500000,10284523,11758418,2005,1473895,shopgirl20051021,shopgirl2005
64,2002-03-08,men with brooms,7500000,4239767,4239767,2002,0,menwithbrooms20020308,men with brooms2002
65,2008-02-22,witless protection,7500000,4151836,4151836,2008,0,witlessprotection20080222,witless protection2008
66,2004-11-24,the work and the glory,7500000,3347647,3347647,2004,0,theworkandtheglory20041124,the work and the glory2004
67,2011-12-21,albert nobbs,7500000,3014696,8539003,2011,5524307,albertnobbs20111221,albert nobbs2011
68,2016-06-24,the neon demon,7500000,1333124,3559803,2016,2226679,theneondemon20160624,the neon demon2016
69,2003-07-24,masked and anonymous,7500000,533344,555335,2003,21991,maskedandanonymous20030724,masked and anonymous2003
70,2018-04-13,borg vs mcenroe,7500000,231346,3257922,2018,3026576,borgvsmcenroe20180413,borg vs mcenroe2018
71,2002-09-13,betty fisher et autres histoires,7500000,206400,206400,2002,0,bettyfisheretautreshistoires20020913,betty fisher et autres histoires2002
72,2004-08-06,code 46,7500000,197148,1788324,2004,1591176,code4620040806,code 462004
73,2001-12-31,the hole,7500000,0,10834406,2001,10834406,thehole20011231,the hole2001
74,2015-01-09,black november,7500000,0,32572,2015,32572,blacknovember20150109,black november2015
75,2015-02-24,outside bet,7500000,0,13524,2015,13524,outsidebet20150224,outside bet2015
76,2015-05-15,pound of flesh,7500000,0,0,2015,0,poundofflesh20150515,pound of flesh2015
77,2017-01-13,the bye bye man,7400000,22395806,31187727,2017,8791921,thebyebyeman20170113,the bye bye man2017
78,2007-04-27,ta ra rum pum,7400000,872643,9443864,2007,8571221,tararumpum20070427,ta ra rum pum2007
79,2005-05-06,crash,7303082,55334418,101173038,2005,45838620,crash20050506,crash2005
80,2007-12-25,persepolis,7300000,4443403,25397187,2007,20953784,persepolis20071225,persepolis2007
81,2010-04-30,harry brown,7300000,1818681,12023606,2010,10204925,harrybrown20100430,harry brown2010
82,2011-05-27,die welle,7250000,0,35122948,2011,35122948,diewelle20110527,die welle2011
85,2011-09-16,3,7200000,59774,295492,2011,235718,320110916,32011
86,2007-12-05,juno,7000000,143495265,231450102,2007,87954837,juno20071205,juno2007
88,2012-06-29,magic mike,7000000,113721571,170549753,2012,56828182,magicmike20120629,magic mike2012
90,2018-03-16,i can only imagine,7000000,83482352,85604221,2018,2121869,icanonlyimagine20180316,i can only imagine2018
91,2019-03-15,five feet apart,7000000,45729221,80504421,2019,34775200,fivefeetapart20190315,five feet apart2019
93,2011-05-06,jumping the broom,7000000,37295394,38158601,2011,863207,jumpingthebroom20110506,jumping the broom2011
95,2000-01-12,my dog skip,7000000,34099640,35795319,2000,1695679,mydogskip20000112,my dog skip2000
96,2003-01-24,darkness falls,7000000,32539681,47289758,2003,14750077,darknessfalls20030124,darkness falls2003
97,2008-02-14,"definitely, maybe",7000000,32241649,55617866,2008,23376217,definitelymaybe20080214,"definitely, maybe2008"
98,2005-10-07,"good night, and good luck",7000000,31501218,56586901,2005,25085683,goodnightandgoodluck20051007,"good night, and good luck2005"
99,2005-09-30,capote,7000000,28750530,49924079,2005,21173549,capote20050930,capote2005
1,2006-08-04,the descent,7000000,26024456,57051053,2006,31026597,thedescent20060804,the descent2006
4,2017-04-07,gifted,7000000,24801212,36964656,2017,12163444,gifted20170407,gifted2017
6,2001-04-11,kingdom come,7000000,23247539,23393939,2001,146400,kingdomcome20010411,kingdom come2001
10,2000-05-05,michael jordan to the max,7000000,18642318,18642318,2000,0,michaeljordantothemax20000505,michael jordan to the max2000
11,2015-06-19,dope,7000000,17506470,18190831,2015,684361,dope20150619,dope2015
12,2005-07-22,the devil's rejects,7000000,17044981,20940428,2005,3895447,thedevilsrejects20050722,the devil's rejects2005
13,2019-05-24,brightburn,7000000,16794432,27989498,2019,11195066,brightburn20190524,brightburn2019
14,2014-01-17,devil's due,7000000,15821461,36146087,2014,20324626,devilsdue20140117,devil's due2014
16,2014-11-14,beyond the lights,7000000,14618727,14618727,2014,0,beyondthelights20141114,beyond the lights2014
19,2003-04-11,"house of 1,000 corpses",7000000,12634962,17005466,2003,4370504,houseof1000corpses20030411,"house of 1,000 corpses2003"
21,2003-10-10,house of the dead,7000000,10199354,13860078,2003,3660724,houseofthedead20031010,house of the dead2003
22,2009-10-02,a serious man,7000000,9228788,30360570,2009,21131782,aseriousman20091002,a serious man2009
23,2010-07-30,get low,7000000,9176933,10828305,2010,1651372,getlow20100730,get low2010
24,2009-12-11,a single man,7000000,9176000,28142379,2009,18966379,asingleman20091211,a single man2009
27,2010-06-18,cyrus,7000000,7468936,10062896,2010,2593960,cyrus20100618,cyrus2010
29,2005-02-11,bride & prejudice,7000000,6601079,25269040,2005,18667961,brideprejudice20050211,bride & prejudice2005
30,2002-11-29,rabbit-proof fence,7000000,6199600,16866928,2002,10667328,rabbitprooffence20021129,rabbit-proof fence2002
31,2007-07-27,who's your caddy?,7000000,5694308,5694308,2007,0,whosyourcaddy20070727,who's your caddy?2007
34,2001-12-14,the other side of heaven,7000000,4720371,4720371,2001,0,theothersideofheaven20011214,the other side of heaven2001
37,2004-11-12,veer-zaara,7000000,2938532,7017859,2004,4079327,veerzaara20041112,veer-zaara2004
38,2008-05-02,redbelt,7000000,2344847,2667084,2008,322237,redbelt20080502,redbelt2008
40,2002-10-18,auto focus,7000000,2062066,2703821,2002,641755,autofocus20021018,auto focus2002
41,2011-10-21,the mighty macs,7000000,1891936,1891936,2011,0,themightymacs20111021,the mighty macs2011
42,2010-12-22,somewhere,7000000,1785645,17023121,2010,15237476,somewhere20101222,somewhere2010
43,2012-01-13,we need to talk about kevin,7000000,1738692,10765283,2012,9026591,weneedtotalkaboutkevin20120113,we need to talk about kevin2012
44,2007-02-02,factory girl,7000000,1661464,1661464,2007,0,factorygirl20070202,factory girl2007
45,2013-11-15,the christmas candle,7000000,1632000,1933829,2013,301829,thechristmascandle20131115,the christmas candle2013
46,2009-09-25,i hope they serve beer in hell,7000000,1429299,1429453,2009,154,ihopetheyservebeerinhell20090925,i hope they serve beer in hell2009
48,2010-05-07,mother and child,7000000,1110509,6537179,2010,5426670,motherandchild20100507,mother and child2010
51,2015-10-02,freeheld,7000000,546201,1732228,2015,1186027,freeheld20151002,freeheld2015
52,2014-04-02,dom hemingway,7000000,523511,1857458,2014,1333947,domhemingway20140402,dom hemingway2014
53,2010-07-30,the extra man,7000000,453377,492108,2010,38731,theextraman20100730,the extra man2010
54,2011-05-13,hesher,7000000,382946,382946,2011,0,hesher20110513,hesher2011
56,2003-02-14,gerry,7000000,254683,719699,2003,465016,gerry20030214,gerry2003
57,2006-05-12,wah-wah,7000000,234750,463039,2006,228289,wahwah20060512,wah-wah2006
58,2003-06-13,the heart of me,7000000,196067,196067,2003,0,theheartofme20030613,the heart of me2003
59,2010-03-26,ca$h,7000000,46488,46488,2010,0,cah20100326,ca$h2010
60,2015-01-30,trudno byt bogom,7000000,31443,41038,2015,9595,trudnobytbogom20150130,trudno byt bogom2015
61,2000-01-21,the boondock saints,7000000,30471,411874,2000,381403,theboondocksaints20000121,the boondock saints2000
62,2014-01-28,snezhnaya koroleva,7000000,0,15193977,2014,15193977,snezhnayakoroleva20140128,snezhnaya koroleva2014
63,2016-12-06,oddball,7000000,0,10237229,2016,10237229,oddball20161206,oddball2016
64,2015-08-18,z storm,7000000,0,2053330,2015,2053330,zstorm20150818,z storm2015
65,2015-12-31,geroy,7000000,0,1545121,2015,1545121,geroy20151231,geroy2015
66,2013-07-23,twixt,7000000,0,1268346,2013,1268346,twixt20130723,twixt2013
67,2015-11-20,criminal activities,7000000,0,386744,2015,386744,criminalactivities20151120,criminal activities2015
68,2007-12-11,high school musical 2,7000000,0,0,2007,0,highschoolmusical220071211,high school musical 22007
69,2008-12-12,the kings of appletown,7000000,0,0,2008,0,thekingsofappletown20081212,the kings of appletown2008
70,2008-03-11,stargate - the ark of truth,7000000,0,0,2008,0,stargatethearkoftruth20080311,stargate - the ark of truth2008
71,2015-09-01,alpha & omega: the legend of the saw tooth cave,7000000,0,0,2015,0,alphaomegathelegendofthesawtoothcave20150901,alpha & omega: the legend of the saw tooth cave2015
73,2012-09-21,house at the end of the street,6900000,31611916,44103982,2012,12492066,houseattheendofthestreet20120921,house at the end of the street2012
75,2017-01-31,two lovers and a bear,6840000,0,22273,2017,22273,twoloversandabear20170131,two lovers and a bear2017
76,2010-09-17,incendies,6800000,6857096,16038343,2010,9181247,incendies20100917,incendies2010
77,2000-08-11,aimã©e & jaguar,6800000,927107,927107,2000,0,aimãejaguar20000811,aimã©e & jaguar2000
78,2005-08-05,the chumscrubber,6800000,49526,49526,2005,0,thechumscrubber20050805,the chumscrubber2005
79,2004-04-09,shade,6800000,25032,9533964,2004,9508932,shade20040409,shade2004
80,2010-09-10,bran nue dae,6750000,113568,6812530,2010,6698962,brannuedae20100910,bran nue dae2010
81,2004-09-03,"remember me, my love",6700000,223878,223878,2004,0,remembermemylove20040903,"remember me, my love2004"
82,2010-05-21,perrierâs bounty,6600000,828,828,2010,0,perrierâsbounty20100521,perrierâs bounty2010
83,2008-09-19,tropa de elite,6537890,8744,14319195,2008,14310451,tropadeelite20080919,tropa de elite2008
84,2014-10-03,annabelle,6500000,84273813,256862920,2014,172589107,annabelle20141003,annabelle2014
85,2008-02-01,hannah montana/miley cyrus: best of both worlds concert tour,6500000,65281781,70712099,2008,5430318,hannahmontanamileycyrusbestofbothworldsconcerttour20080201,hannah montana/miley cyrus: best of both worlds concert tour2008
92,2006-04-07,friends with money,6500000,13368437,18110152,2006,4741715,friendswithmoney20060407,friends with money2006
95,2017-10-20,same kind of different as me,6500000,6423605,6423605,2017,0,samekindofdifferentasme20171020,same kind of different as me2017
96,2003-03-07,nowhere in africa,6500000,6173485,6173485,2003,0,nowhereinafrica20030307,nowhere in africa2003
97,2011-12-02,shame,6500000,4002293,20412841,2011,16410548,shame20111202,shame2011
98,2005-05-13,layer cake,6500000,2339957,11745931,2005,9405974,layercake20050513,layer cake2005
99,2013-05-31,the east,6500000,2274649,3027956,2013,753307,theeast20130531,the east2013
100,2005-10-21,the work and the glory: american zion,6500000,2025032,2025032,2005,0,theworkandthegloryamericanzion20051021,the work and the glory: american zion2005
1,2009-11-13,the messenger,6500000,1109660,1744952,2009,635292,themessenger20091113,the messenger2009
2,2004-07-23,a home at the end of the world,6500000,1029017,1033810,2004,4793,ahomeattheendoftheworld20040723,a home at the end of the world2004
3,2001-08-17,aberdeen,6500000,64148,64148,2001,0,aberdeen20010817,aberdeen2001
4,2011-12-31,tracker,6500000,0,3149,2011,3149,tracker20111231,tracker2011
6,2004-02-27,"good bye, lenin!",6400000,4063859,79384539,2004,75320680,goodbyelenin20040227,"good bye, lenin!2004"
7,2007-10-10,control,6400000,871577,8902141,2007,8030564,control20071010,control2007
8,2009-10-09,the damned united,6400000,449865,4199874,2009,3750009,thedamnedunited20091009,the damned united2009
9,2008-02-22,die fã¤lscher,6250000,5488570,20199663,2008,14711093,diefãlscher20080222,die fã¤lscher2008
11,2009-02-13,gomorra,6200000,1579146,37339594,2009,35760448,gomorra20090213,gomorra2009
15,2004-06-23,fahrenheit 9/11,6000000,119114517,221148959,2004,102034442,fahrenheit91120040623,fahrenheit 9/112004
19,2018-05-11,breaking in,6000000,46840590,51411620,2018,4571030,breakingin20180511,breaking in2018
23,2001-03-23,the brothers,6000000,27457409,27958191,2001,500782,thebrothers20010323,the brothers2001
24,2008-12-17,the wrestler,6000000,26238243,46634275,2008,20396032,thewrestler20081217,the wrestler2008
30,2002-04-05,national lampoonâs van wilder,6000000,21305259,39241323,2002,17936064,nationallampoonâsvanwilder20020405,national lampoonâs van wilder2002
32,2000-09-27,best in show,6000000,18621249,20695413,2000,2074164,bestinshow20000927,best in show2000
33,2019-03-29,unplanned,6000000,18107621,18107621,2019,0,unplanned20190329,unplanned2019
34,2006-09-27,the last king of scotland,6000000,17606684,49155371,2006,31548687,thelastkingofscotland20060927,the last king of scotland2006
35,2003-04-16,a mighty wind,6000000,17583468,18504539,2003,921071,amightywind20030416,a mighty wind2003
36,2019-02-08,the prodigy,6000000,14856291,19789712,2019,4933421,theprodigy20190208,the prodigy2019
37,2018-11-30,the possession of hannah grace,6000000,14836174,42785387,2018,27949213,thepossessionofhannahgrace20181130,the possession of hannah grace2018
39,2007-08-08,daddy day camp,6000000,13235267,18209872,2007,4974605,daddydaycamp20070808,daddy day camp2007
46,2012-09-07,the words,6000000,11494838,16369708,2012,4874870,thewords20120907,the words2012
47,2016-01-15,the lady in the van,6000000,10021175,42320503,2016,32299328,theladyinthevan20160115,the lady in the van2016
48,2012-04-27,bernie,6000000,9204489,10106975,2012,902486,bernie20120427,bernie2012
49,2000-12-15,pollock,6000000,8596914,10557291,2000,1960377,pollock20001215,pollock2000
50,2008-02-15,dolphins and whales tribes of the ocean 3d,6000000,7714996,17252287,2008,9537291,dolphinsandwhalestribesoftheocean3d20080215,dolphins and whales tribes of the ocean 3d2008
52,2010-03-19,city island,6000000,6671283,8173486,2010,1502203,cityisland20100319,city island2010
53,2012-03-16,casa de mi padre,6000000,5909483,8446952,2012,2537469,casademipadre20120316,casa de mi padre2012
54,2011-07-29,the guard,6000000,5359774,21197454,2011,15837680,theguard20110729,the guard2011
55,2000-04-21,the virgin suicides,6000000,4859475,10619770,2000,5760295,thevirginsuicides20000421,the virgin suicides2000
56,2008-08-29,college,6000000,4694491,6176114,2008,1481623,college20080829,college2008
57,2006-09-22,la science des rãªves,6000000,4670644,15137932,2006,10467288,lasciencedesrãªves20060922,la science des rãªves2006
59,2009-03-13,miss march,6000000,4543320,4713059,2009,169739,missmarch20090313,miss march2009
61,2014-07-18,wish i was here,6000000,3591299,6591365,2014,3000066,wishiwashere20140718,wish i was here2014
62,2006-12-21,venus,6000000,3347411,7818479,2006,4471068,venus20061221,venus2006
63,2014-03-14,veronica mars,6000000,3322127,3485383,2014,163256,veronicamars20140314,veronica mars2014
65,2001-07-20,hedwig and the angry inch,6000000,3067312,3740030,2001,672718,hedwigandtheangryinch20010720,hedwig and the angry inch2001
66,2003-10-31,shattered glass,6000000,2207975,3456602,2003,1248627,shatteredglass20031031,shattered glass2003
67,2008-07-03,the wackness,6000000,2077046,3330012,2008,1252966,thewackness20080703,the wackness2008
68,2001-11-16,novocaine,6000000,2025238,2522928,2001,497690,novocaine20011116,novocaine2001
69,2009-02-06,polytechnique,6000000,1418304,1418304,2009,0,polytechnique20090206,polytechnique2009
70,2011-07-15,snow flower and the secret fan,6000000,1348205,11348205,2011,10000000,snowflowerandthesecretfan20110715,snow flower and the secret fan2011
71,2018-09-14,mandy,6000000,1214525,1427656,2018,213131,mandy20180914,mandy2018
72,2001-12-07,the business of strangers,6000000,1030920,1290920,2001,260000,thebusinessofstrangers20011207,the business of strangers2001
73,2011-04-29,jã»san-nin no shikaku,6000000,802778,18727440,2011,17924662,jãsanninnoshikaku20110429,jã»san-nin no shikaku2011
76,2011-03-25,the 5th quarter,6000000,408159,408159,2011,0,the5thquarter20110325,the 5th quarter2011
78,2002-12-20,morvern callar,6000000,267194,267194,2002,0,morverncallar20021220,morvern callar2002
79,2003-10-10,the flower of evil,6000000,181798,181798,2003,0,theflowerofevil20031010,the flower of evil2003
80,2011-03-04,akmareul boatda,6000000,129210,13168809,2011,13039599,akmareulboatda20110304,akmareul boatda2011
81,2006-11-10,come early morning,6000000,119452,119452,2006,0,comeearlymorning20061110,come early morning2006
82,2010-04-02,the greatest,6000000,115862,117796,2010,1934,thegreatest20100402,the greatest2010
83,2012-12-07,deadfall,6000000,66351,1673635,2012,1607284,deadfall20121207,deadfall2012
84,2009-05-08,julia,6000000,65108,1365108,2009,1300000,julia20090508,julia2009
85,2002-04-05,lucky break,6000000,54606,4316497,2002,4261891,luckybreak20020405,lucky break2002
86,2008-09-05,"surfer, dude",6000000,36497,36497,2008,0,surferdude20080905,"surfer, dude2008"
87,2015-01-23,song one,6000000,32251,437089,2015,404838,songone20150123,song one2015
88,2007-10-03,lake of fire,6000000,25317,26007,2007,690,lakeoffire20071003,lake of fire2007
89,2010-04-02,don mckay,6000000,13722,13722,2010,0,donmckay20100402,don mckay2010
90,2005-08-12,11:14,6000000,0,0,2005,0,111420050812,11:142005
91,2010-02-09,icarus,6000000,0,0,2010,0,icarus20100209,icarus2010
93,2011-03-15,a shine of rainbows,6000000,0,0,2011,0,ashineofrainbows20110315,a shine of rainbows2011
94,2011-12-31,freaky deaky,6000000,0,0,2011,0,freakydeaky20111231,freaky deaky2011
95,2011-05-10,the hit list,6000000,0,0,2011,0,thehitlist20110510,the hit list2011
98,2003-03-21,l\'auberge espagnole,5900000,3895664,3895664,2003,0,laubergeespagnole20030321,l\'auberge espagnole2003
1,2011-03-18,winter in wartime,5800000,542860,9662214,2011,9119354,winterinwartime20110318,winter in wartime2011
2,2003-10-03,foolproof,5800000,230312,421021,2003,190709,foolproof20031003,foolproof2003
3,2012-10-05,trade of innocents,5800000,15091,15091,2012,0,tradeofinnocents20121005,trade of innocents2012
4,2006-09-08,tom yum goong,5700000,12044087,43044087,2006,31000000,tomyumgoong20060908,tom yum goong2006
6,2012-09-07,the inbetweeners,5700000,35955,86051320,2012,86015365,theinbetweeners20120907,the inbetweeners2012
7,2010-07-16,valhalla rising,5700000,30638,731613,2010,700975,valhallarising20100716,valhalla rising2010
8,2003-03-12,bend it like beckham,5600000,32543449,74566042,2003,42022593,benditlikebeckham20030312,bend it like beckham2003
9,2006-09-01,crossover,5600000,7009668,7009668,2006,0,crossover20060901,crossover2006
10,2002-06-21,sunshine state,5600000,3064356,3281898,2002,217542,sunshinestate20020621,sunshine state2002
11,2010-07-16,standing ovation,5600000,531806,531806,2010,0,standingovation20100716,standing ovation2010
12,2012-12-07,khiladi 786,5600000,385422,14683763,2012,14298341,khiladi78620121207,khiladi 7862012
13,2010-07-09,[rec] 2,5600000,27766,18527766,2010,18500000,rec220100709,[rec] 22010
16,2005-02-25,diary of a mad black woman,5500000,50406346,50458356,2005,52010,diaryofamadblackwoman20050225,diary of a mad black woman2005
18,2013-09-27,don jon,5500000,24477704,41268579,2013,16790875,donjon20130927,don jon2013
20,2018-09-28,hell fest,5500000,11107431,18119231,2018,7011800,hellfest20180928,hell fest2018
21,2003-06-06,mambo italiano,5500000,9282750,12399772,2003,3117022,mamboitaliano20030606,mambo italiano2003
22,2001-07-20,ghost world,5500000,6217849,8761608,2001,2543759,ghostworld20010720,ghost world2001
23,2001-12-14,iris,5500000,5580479,5580479,2001,0,iris20011214,iris2001
25,2004-11-26,les choristes,5500000,3629758,83529758,2004,79900000,leschoristes20041126,les choristes2004
26,2003-10-03,wonderland,5500000,1060512,1060512,2003,0,wonderland20031003,wonderland2003
27,2005-07-01,de battre mon coeur s'est arrãªtã©,5500000,1023424,8589831,2005,7566407,debattremoncoeursestarrãªtã20050701,de battre mon coeur s'est arrãªtã©2005
28,2011-04-01,haevnen,5500000,1008098,15867314,2011,14859216,haevnen20110401,haevnen2011
29,2011-10-21,le havre,5500000,611709,13480196,2011,12868487,lehavre20111021,le havre2011
30,2002-05-17,harvard man,5500000,56653,56653,2002,0,harvardman20020517,harvard man2002
31,2011-07-15,salvation boulevard,5500000,28468,28468,2011,0,salvationboulevard20110715,salvation boulevard2011
32,2015-01-23,r100,5500000,24956,24956,2015,0,r10020150123,r1002015
33,2015-05-05,miss julie,5500000,0,863895,2015,863895,missjulie20150505,miss julie2015
34,2008-12-31,animals,5500000,0,0,2008,0,animals20081231,animals2008
35,2003-03-07,irreversible,5400000,792200,8133256,2003,7341056,irreversible20030307,irreversible2003
36,2013-02-26,tao jie,5400000,0,4728896,2013,4728896,taojie20130226,tao jie2013
37,2006-01-27,rang de basanti,5300000,2197694,29197694,2006,27000000,rangdebasanti20060127,rang de basanti2006
38,2013-07-19,grabbers,5300000,0,440821,2013,440821,grabbers20130719,grabbers2013
39,2013-10-11,la vie d'adã¨le â chapitres 1 & 2,5250000,2450504,22914479,2013,20463975,laviedadãleâchapitres1220131011,la vie d'adã¨le â chapitres 1 & 22013
40,2012-04-27,hodejegerne,5250000,1200010,20188740,2012,18988730,hodejegerne20120427,hodejegerne2012
41,2007-08-03,the ten,5250000,769726,786677,2007,16951,theten20070803,the ten2007
42,2000-10-27,a room for romeo brass,5250000,20097,20097,2000,0,aroomforromeobrass20001027,a room for romeo brass2000
43,2017-02-24,the girl with all the gifts,5250000,0,4801837,2017,4801837,thegirlwithallthegifts20170224,the girl with all the gifts2017
45,2005-08-05,saint ralph,5200000,795126,1695126,2005,900000,saintralph20050805,saint ralph2005
46,2011-04-22,dum maaro dum,5200000,564489,11633427,2011,11068938,dummaarodum20110422,dum maaro dum2011
48,2002-04-19,my big fat greek wedding,5000000,241438208,374890034,2002,133451826,mybigfatgreekwedding20020419,my big fat greek wedding2002
49,2017-02-24,get out,5000000,176040665,255367951,2017,79327286,getout20170224,get out2017
50,2017-01-20,split,5000000,138141585,278964806,2017,140823221,split20170120,split2017
51,2011-10-21,paranormal activity 3,5000000,104028807,207039844,2011,103011037,paranormalactivity320111021,paranormal activity 32011
52,2005-10-28,saw ii,5000000,87025093,152925093,2005,65900000,sawii20051028,saw ii2005
53,2013-09-13,insidious chapter 2,5000000,83586447,161921515,2013,78335068,insidiouschapter220130913,insidious chapter 22013
54,2016-03-11,10 cloverfield lane,5000000,72082999,108286422,2016,36203423,10cloverfieldlane20160311,10 cloverfield lane2016
55,2016-07-22,lights out,5000000,67268835,148806510,2016,81537675,lightsout20160722,lights out2016
56,2015-09-11,the visit,5000000,65206105,98677816,2015,33471711,thevisit20150911,the visit2015
57,2002-10-25,jackass: the movie,5000000,64282312,79282312,2002,15000000,jackassthemovie20021025,jackass: the movie2002
58,2017-10-13,happy death day,5000000,55683845,125010260,2017,69326415,happydeathday20171013,happy death day2017
59,2012-10-19,paranormal activity 4,5000000,53900335,142817992,2012,88917657,paranormalactivity420121019,paranormal activity 42012
60,2014-10-24,ouija,5000000,50856010,103300632,2014,52444622,ouija20141024,ouija2014
62,2013-08-30,no se aceptan devoluciones,5000000,44467206,100486616,2013,56019410,noseaceptandevoluciones20130830,no se aceptan devoluciones2013
63,2015-08-07,the gift,5000000,43787265,58978477,2015,15191212,thegift20150807,the gift2015
64,2017-06-23,the big sick,5000000,42872467,53972860,2017,11100393,thebigsick20170623,the big sick2017
66,2019-05-31,ma,5000000,36049540,44300625,2019,8251085,ma20190531,ma2019
69,2003-12-24,monster,5000000,34469210,64240813,2003,29771603,monster20031224,monster2003
70,2014-01-03,paranormal activity: the marked ones,5000000,32462372,90904854,2014,58442482,paranormalactivitythemarkedones20140103,paranormal activity: the marked ones2014
72,2014-04-11,oculus,5000000,27695246,44115496,2014,16420250,oculus20140411,oculus2014
73,2013-11-01,dallas buyers club,5000000,27298285,60611845,2013,33313560,dallasbuyersclub20131101,dallas buyers club2013
74,2015-08-26,no escape,5000000,27288872,42844516,2015,15555644,noescape20150826,no escape2015
76,2015-02-27,the lazarus effect,5000000,25801570,38359310,2015,12557740,thelazaruseffect20150227,the lazarus effect2015
77,2001-03-16,memento,5000000,25544867,39723096,2001,14178229,memento20010316,memento2001
78,2011-08-26,our idiot brother,5000000,24814830,25861249,2011,1046419,ouridiotbrother20110826,our idiot brother2011
79,2018-03-09,the strangers: prey at night,5000000,24431472,29960051,2018,5528579,thestrangerspreyatnight20180309,the strangers: prey at night2018
80,2006-07-21,clerks ii,5000000,24148068,27342246,2006,3194178,clerksii20060721,clerks ii2006
82,2000-10-13,billy elliot,5000000,21995263,109253745,2000,87258482,billyelliot20001013,billy elliot2000
83,2013-07-05,the way way back,5000000,21502690,26853810,2013,5351120,thewaywayback20130705,the way way back2013
84,2014-08-29,"as above, so below",5000000,21222315,41824066,2014,20601751,asabovesobelow20140829,"as above, so below2014"
85,2016-04-01,godâs not dead 2,5000000,20773069,23551286,2016,2778217,godâsnotdead220160401,godâs not dead 22016
90,2016-02-19,race,5000000,19115191,23745772,2016,4630581,race20160219,race2016
92,2015-01-16,still alice,5000000,18656400,41699612,2015,23043212,stillalice20150116,still alice2015
94,2011-09-02,apollo 18,5000000,17686929,26517819,2011,8830890,apollo1820110902,apollo 182011
95,2018-03-23,"paul, apostle of christ",5000000,17547999,25529498,2018,7981499,paulapostleofchrist20180323,"paul, apostle of christ2018"
96,2014-10-10,addicted,5000000,17390770,17499242,2014,108472,addicted20141010,addicted2014
97,2001-08-31,o (othello),5000000,16017403,16017403,2001,0,oothello20010831,o (othello)2001
3,2013-03-15,spring breakers,5000000,14124286,31149251,2013,17024965,springbreakers20130315,spring breakers2013
4,2017-06-09,it comes at night,5000000,13985117,19720203,2017,5735086,itcomesatnight20170609,it comes at night2017
5,2002-03-15,y tu mamã¡ tambiã©n,5000000,13649881,33649881,2002,20000000,ytumamãtambiãn20020315,y tu mamã¡ tambiã©n2002
6,2004-09-24,shaun of the dead,5000000,13542874,30332385,2004,16789511,shaunofthedead20040924,shaun of the dead2004
7,2008-10-31,the haunting of molly hartley,5000000,13442412,15318257,2008,1875845,thehauntingofmollyhartley20081031,the haunting of molly hartley2008
8,2016-07-15,hillaryâs america: the secret history of the democratic party,5000000,13099931,13099931,2016,0,hillaryâsamericathesecrethistoryofthedemocraticparty20160715,hillaryâs america: the secret history of the democratic party2016
12,2017-03-03,before i fall,5000000,12241072,18945682,2017,6704610,beforeifall20170303,before i fall2017
14,2009-03-13,sunshine cleaning,5000000,12062558,17329337,2009,5266779,sunshinecleaning20090313,sunshine cleaning2009
15,2016-01-29,fifty shades of black,5000000,11686940,22113075,2016,10426135,fiftyshadesofblack20160129,fifty shades of black2016
19,2009-01-09,not easily broken,5000000,10572742,10732909,2009,160167,noteasilybroken20090109,not easily broken2009
20,2014-05-09,momsâ night out,5000000,10429707,10537341,2014,107634,momsânightout20140509,momsâ night out2014
21,2017-03-17,the belko experiment,5000000,10166820,11792942,2017,1626122,thebelkoexperiment20170317,the belko experiment2017
22,2016-03-11,the perfect match,5000000,9669521,10182050,2016,512529,theperfectmatch20160311,the perfect match2016
23,2000-10-06,digimon: the movie,5000000,9628751,16628751,2000,7000000,digimonthemovie20001006,digimon: the movie2000
24,2004-05-28,saved!,5000000,8886160,10206551,2004,1320391,saved20040528,saved!2004
25,2003-05-09,les invasions barbares,5000000,8460000,25913869,2003,17453869,lesinvasionsbarbares20030509,les invasions barbares2003
28,2001-04-27,the forsaken,5000000,6755271,6755271,2001,0,theforsaken20010427,the forsaken2001
29,2018-09-21,fahrenheit 11/9,5000000,6352306,6653715,2018,301409,fahrenheit11920180921,fahrenheit 11/92018
31,2010-05-28,sea rex 3d: journey to a prehistoric world,5000000,6096582,16515203,2010,10418621,searex3djourneytoaprehistoricworld20100528,sea rex 3d: journey to a prehistoric world2010
32,2006-01-06,grandmaâs boy,5000000,6090172,6590172,2006,500000,grandmaâsboy20060106,grandmaâs boy2006
35,2001-07-13,made,5000000,5308707,5476060,2001,167353,made20010713,made2001
36,2004-11-19,la mala educaciã³n,5000000,5211842,40311842,2004,35100000,lamalaeducaciã³n20041119,la mala educaciã³n2004
37,2009-06-12,moon,5000000,5010163,10676073,2009,5665910,moon20090612,moon2009
38,2015-09-11,90 minutes in heaven,5000000,4816142,4816142,2015,0,90minutesinheaven20150911,90 minutes in heaven2015
39,2016-12-02,incarnate,5000000,4799774,9371036,2016,4571262,incarnate20161202,incarnate2016
40,2006-05-12,keeping up with the steins,5000000,4339241,4414753,2006,75512,keepingupwiththesteins20060512,keeping up with the steins2006
42,2008-08-06,bottle shock,5000000,4078607,4815890,2008,737283,bottleshock20080806,bottle shock2008
43,2011-02-25,des hommes et des dieux,5000000,3954651,46263525,2011,42308874,deshommesetdesdieux20110225,des hommes et des dieux2011
45,2017-03-03,table 19,5000000,3614896,4620399,2017,1005503,table1920170303,table 192017
46,2016-04-15,green room,5000000,3220371,3807503,2016,587132,greenroom20160415,green room2016
47,2018-03-09,thoroughbreds,5000000,3072605,3187302,2018,114697,thoroughbreds20180309,thoroughbreds2018
49,2016-03-04,the other side of the door,5000000,3000342,12905107,2016,9904765,theothersideofthedoor20160304,the other side of the door2016
50,2011-05-13,everything must go,5000000,2712131,2821010,2011,108879,everythingmustgo20110513,everything must go2011
51,2014-10-10,kill the messenger,5000000,2450846,6656705,2014,4205859,killthemessenger20141010,kill the messenger2014
52,2010-12-17,rabbit hole,5000000,2229058,6205034,2010,3975976,rabbithole20101217,rabbit hole2010
53,2015-10-23,jem and the holograms,5000000,2184640,2368937,2015,184297,jemandtheholograms20151023,jem and the holograms2015
54,2016-12-28,paterson,5000000,2141423,10727536,2016,8586113,paterson20161228,paterson2016
57,2004-10-22,the machinist,5000000,1082044,8655397,2004,7573353,themachinist20041022,the machinist2004
59,2008-07-25,american teen,5000000,942441,989319,2008,46878,americanteen20080725,american teen2008
60,2014-09-12,atlas shrugged: who is john galt?,5000000,851690,851690,2014,0,atlasshruggedwhoisjohngalt20140912,atlas shrugged: who is john galt?2014
61,2003-08-29,party monster,5000000,742898,894030,2003,151132,partymonster20030829,party monster2003
62,2006-07-14,the oh in ohio,5000000,418689,648183,2006,229494,theohinohio20060714,the oh in ohio2006
64,2013-08-16,ain't them bodies saints,5000000,391611,1075009,2013,683398,aintthembodiessaints20130816,ain't them bodies saints2013
66,2014-09-26,jimi: all is by my side,5000000,340911,927074,2014,586163,jimiallisbymyside20140926,jimi: all is by my side2014
67,2007-08-03,"gandhi, my father",5000000,240425,2015004,2007,1774579,gandhimyfather20070803,"gandhi, my father2007"
68,2008-04-25,standard operating procedure,5000000,228830,332120,2008,103290,standardoperatingprocedure20080425,standard operating procedure2008
69,2011-09-30,tucker & dale vs. evil,5000000,223838,5476793,2011,5252955,tuckerdalevsevil20110930,tucker & dale vs. evil2011
71,2015-08-07,cop car,5000000,134552,143658,2015,9106,copcar20150807,cop car2015
72,2010-09-10,"lovely, still",5000000,127564,282687,2010,155123,lovelystill20100910,"lovely, still2010"
73,2003-06-13,tycoon,5000000,121016,121016,2003,0,tycoon20030613,tycoon2003
75,2004-02-27,decoys,5000000,84733,96760,2004,12027,decoys20040227,decoys2004
76,2008-05-30,stuck,5000000,67505,67505,2008,0,stuck20080530,stuck2008
77,2007-11-16,redacted,5000000,65388,861325,2007,795937,redacted20071116,redacted2007
78,2014-10-17,rudderless,5000000,56001,567219,2014,511218,rudderless20141017,rudderless2014
79,2005-01-28,fascination,5000000,16670,83356,2005,66686,fascination20050128,fascination2005
80,2009-08-14,grace,5000000,8297,8297,2009,0,grace20090814,grace2009
81,2015-05-15,area 51,5000000,7556,7556,2015,0,area5120150515,area 512015
82,2012-10-26,mientras duermes,5000000,0,9109597,2012,9109597,mientrasduermes20121026,mientras duermes2012
83,2009-07-07,flying by,5000000,0,4568257,2009,4568257,flyingby20090707,flying by2009
84,2008-12-31,the cottage,5000000,0,1504960,2008,1504960,thecottage20081231,the cottage2008
85,2014-12-05,dying of the light,5000000,0,74639,2014,74639,dyingofthelight20141205,dying of the light2014
86,2016-09-02,yoga hosers,5000000,0,22958,2016,22958,yogahosers20160902,yoga hosers2016
87,2009-02-17,dead like me: life after death,5000000,0,0,2009,0,deadlikemelifeafterdeath20090217,dead like me: life after death2009
88,2007-01-30,farce of the penguins,5000000,0,0,2007,0,farceofthepenguins20070130,farce of the penguins2007
89,2010-12-31,psych 9,5000000,0,0,2010,0,psych920101231,psych 92010
90,2014-11-21,reach me,5000000,0,0,2014,0,reachme20141121,reach me2014
91,2014-08-18,henry & me,5000000,0,0,2014,0,henryme20140818,henry & me2014
92,2015-01-27,born of war,5000000,0,0,2015,0,bornofwar20150127,born of war2015
93,2015-01-09,let's kill ward's wife,5000000,0,0,2015,0,letskillwardswife20150109,let's kill ward's wife2015
94,2015-01-13,capricorn one,5000000,0,0,2015,0,capricornone20150113,capricorn one2015
95,2011-12-31,we have your husband,5000000,0,0,2011,0,wehaveyourhusband20111231,we have your husband2011
96,2012-12-31,should've been romeo,5000000,0,0,2012,0,shouldvebeenromeo20121231,should've been romeo2012
97,2015-12-31,aztec warrior,5000000,0,0,2015,0,aztecwarrior20151231,aztec warrior2015
98,2015-09-25,navy seal vs. zombies,5000000,0,0,2015,0,navysealvszombies20150925,navy seal vs. zombies2015
99,2016-03-15,the hatching,5000000,0,0,2016,0,thehatching20160315,the hatching2016
100,2015-10-27,running forever,5000000,0,0,2015,0,runningforever20151027,running forever2015
1,2015-01-23,mommy,4900000,3498695,17536004,2015,14037309,mommy20150123,mommy2015
2,2008-08-29,obsluhoval jsem anglickã©ho krã¡le,4900000,617228,7174984,2008,6557756,obsluhovaljsemanglickãhokrãle20080829,obsluhoval jsem anglickã©ho krã¡le2008
3,2010-08-20,soul kitchen,4900000,276901,23347461,2010,23070560,soulkitchen20100820,soul kitchen2010
4,2012-08-17,the awakening,4900000,95933,6924321,2012,6828388,theawakening20120817,the awakening2012
5,2008-01-18,all hat,4900000,15198,15198,2008,0,allhat20080118,all hat2008
7,2006-01-06,hostel,4800000,47326473,82241110,2006,34914637,hostel20060106,hostel2006
8,2013-07-19,only god forgives,4800000,775849,4494560,2013,3718711,onlygodforgives20130719,only god forgives2013
9,2011-09-30,take shelter,4750000,1728953,4972016,2011,3243063,takeshelter20110930,take shelter2011
10,2006-01-27,tristram shandy: a cock and bull story,4750000,1253413,3061763,2006,1808350,tristramshandyacockandbullstory20060127,tristram shandy: a cock and bull story2006
13,2006-10-13,driving lessons,4700000,239962,239962,2006,0,drivinglessons20061013,driving lessons2006
14,2011-12-31,without men,4700000,0,0,2011,0,withoutmen20111231,without men2011
15,2015-03-10,treading water,4700000,0,0,2015,0,treadingwater20150310,treading water2015
17,2004-07-16,camping sauvage,4600000,3479302,3479302,2004,0,campingsauvage20040716,camping sauvage2004
18,2012-09-14,barfi,4600000,2804874,36751984,2012,33947110,barfi20120914,barfi2012
19,2005-03-04,dear frankie,4600000,1340891,3099369,2005,1758478,dearfrankie20050304,dear frankie2005
20,2004-12-29,the assassination of richard nixon,4600000,708776,4880143,2004,4171367,theassassinationofrichardnixon20041229,the assassination of richard nixon2004
21,2011-06-24,le nom des gens,4600000,514237,9261711,2011,8747474,lenomdesgens20110624,le nom des gens2011
22,2008-05-28,savage grace,4600000,434417,968805,2008,534388,savagegrace20080528,savage grace2008
23,2007-10-19,out of the blue,4600000,728,731767,2007,731039,outoftheblue20071019,out of the blue2007
29,2002-12-19,25th hour,4500000,13084595,25344490,2002,12259895,25thhour20021219,25th hour2002
32,2016-03-25,the lobster,4500000,9196278,18019834,2016,8823556,thelobster20160325,the lobster2016
34,2000-10-06,requiem for a dream,4500000,3635482,7389233,2000,3753751,requiemforadream20001006,requiem for a dream2000
36,2008-10-24,lã¥t den rã¤tte komma in,4500000,2122085,12247682,2008,10125597,lãtdenrãttekommain20081024,lã¥t den rã¤tte komma in2008
39,2001-10-26,donnie darko,4500000,1480006,7510877,2001,6030871,donniedarko20011026,donnie darko2001
40,2011-09-02,salvando al soldado perez,4500000,1400726,9330465,2011,7929739,salvandoalsoldadoperez20110902,salvando al soldado perez2011
42,2011-08-19,nannerl la soeur de mozart,4500000,707885,2404639,2011,1696754,nannerllasoeurdemozart20110819,nannerl la soeur de mozart2011
43,2003-03-14,spun,4500000,410241,1022649,2003,612408,spun20030314,spun2003
44,2010-07-23,life during wartime,4500000,281447,281447,2010,0,lifeduringwartime20100723,life during wartime2010
45,2006-05-04,chinjeolhan geumjassi,4500000,211667,23471871,2006,23260204,chinjeolhangeumjassi20060504,chinjeolhan geumjassi2006
46,2011-10-07,blackthorn,4500000,200558,1217307,2011,1016749,blackthorn20111007,blackthorn2011
47,2015-05-08,maggie,4500000,187112,1027760,2015,840648,maggie20150508,maggie2015
48,2003-04-18,lilja 4-ever,4500000,181655,4556982,2003,4375327,lilja4ever20030418,lilja 4-ever2003
49,2010-04-09,after.life,4500000,108596,2481925,2010,2373329,afterlife20100409,after.life2010
50,2002-02-22,mean machine,4500000,92723,92723,2002,0,meanmachine20020222,mean machine2002
51,2007-08-31,fong juk,4500000,51957,51957,2007,0,fongjuk20070831,fong juk2007
52,2010-07-23,spoken word,4500000,32961,32961,2010,0,spokenword20100723,spoken word2010
53,2013-03-01,the sweeney,4500000,26345,8000366,2013,7974021,thesweeney20130301,the sweeney2013
54,2014-09-04,falcon rising,4500000,11774,11774,2014,0,falconrising20140904,falcon rising2014
55,2013-06-25,hansel & gretel get baked,4500000,0,0,2013,0,hanselgretelgetbaked20130625,hansel & gretel get baked2013
56,2014-11-07,fugly,4500000,0,0,2014,0,fugly20141107,fugly2014
57,2015-08-28,zipper,4500000,0,0,2015,0,zipper20150828,zipper2015
58,2015-11-03,the final girls,4500000,0,0,2015,0,thefinalgirls20151103,the final girls2015
59,2017-12-01,daisy winters,4500000,0,0,2017,0,daisywinters20171201,daisy winters2017
62,2016-12-31,airlift (2016),4400000,0,9969237,2016,9969237,airlift201620161231,airlift (2016)2016
63,2015-09-29,r.l. stine's monsterville: the cabinet of souls,4400000,0,0,2015,0,rlstinesmonstervillethecabinetofsouls20150929,r.l. stine's monsterville: the cabinet of souls2015
64,2014-06-06,anna,4357373,0,1200000,2014,1200000,anna20140606,anna2014
65,2003-06-06,whale rider,4300000,20779666,39374600,2003,18594934,whalerider20030606,whale rider2003
66,2001-06-13,sexy beast,4300000,6946056,10158355,2001,3212299,sexybeast20010613,sexy beast2001
67,2009-12-04,paa,4300000,199228,9791282,2009,9592054,paa20091204,paa2009
68,2012-07-11,snabba cash,4300000,188870,10212403,2012,10023533,snabbacash20120711,snabba cash2012
70,2006-02-17,nochnoy dozor,4200000,1502188,33913542,2006,32411354,nochnoydozor20060217,nochnoy dozor2006
71,2010-08-13,animal kingdom,4200000,1044039,8078683,2010,7034644,animalkingdom20100813,animal kingdom2010
72,2010-05-28,george a. romero's survival of the dead,4200000,101740,101740,2010,0,georgearomerossurvivalofthedead20100528,george a. romero's survival of the dead2010
73,2011-10-21,cargo,4200000,0,313230,2011,313230,cargo20111021,cargo2011
74,2006-05-23,high school musical,4200000,0,0,2006,0,highschoolmusical20060523,high school musical2006
79,2003-09-12,lost in translation,4000000,44585453,117085297,2003,72499844,lostintranslation20030912,lost in translation2003
81,2015-01-23,the boy next door,4000000,36006065,53401938,2015,17395873,theboynextdoor20150123,the boy next door2015
84,2001-12-26,monster's ball,4000000,31273922,43766463,2001,12492541,monstersball20011226,monster's ball2001
85,2014-07-11,boyhood,4000000,25379975,57273049,2014,31893074,boyhood20140711,boyhood2014
87,2010-07-09,the kids are all right,4000000,20811365,36275469,2010,15464104,thekidsareallright20100709,the kids are all right2010
89,2014-04-18,a haunted house 2,4000000,17329487,21206861,2014,3877374,ahauntedhouse220140418,a haunted house 22014
90,2013-03-01,the last exorcism part ii,4000000,15179303,25448707,2013,10269404,thelastexorcismpartii20130301,the last exorcism part ii2013
95,2000-08-04,saving grace,4000000,12178602,27786849,2000,15608247,savinggrace20000804,saving grace2000
97,2004-02-06,what the #$'! do we know,4000000,10941801,10941801,2004,0,whatthedoweknow20040206,what the #$'! do we know2004
98,2016-05-13,the darkness,4000000,10753574,10898293,2016,144719,thedarkness20160513,the darkness2016
99,2006-07-28,scoop,4000000,10525717,40103262,2006,29577545,scoop20060728,scoop2006
100,2001-11-14,the wash,4000000,10097096,10097096,2001,0,thewash20011114,the wash2001
1,2000-03-01,3 strikes,4000000,9821335,9821335,2000,0,3strikes20000301,3 strikes2000
2,2008-04-11,the visitor,4000000,9427026,19174817,2008,9747791,thevisitor20080411,the visitor2008
3,2003-11-26,the cooler,4000000,8291572,11131455,2003,2839883,thecooler20031126,the cooler2003
5,2006-08-04,the night listener,4000000,7836393,10770993,2006,2934600,thenightlistener20060804,the night listener2006
7,2007-12-28,el orfanato,4000000,7159147,79250193,2007,72091046,elorfanato20071228,el orfanato2007
8,2007-05-25,bug,4000000,7006708,8302995,2007,1296287,bug20070525,bug2007
9,2002-10-11,the rules of attraction,4000000,6525762,11799060,2002,5273298,therulesofattraction20021011,the rules of attraction2002
11,2006-11-17,let's go to prison,4000000,4630045,4630045,2006,0,letsgotoprison20061117,let's go to prison2006
13,2002-09-20,secretary,4000000,4046737,9413956,2002,5367219,secretary20020920,secretary2002
14,2003-04-25,the real cancun,4000000,3816594,3816594,2003,0,therealcancun20030425,the real cancun2003
18,2012-08-24,samsara,4000000,2672413,5966671,2012,3294258,samsara20120824,samsara2012
19,2007-06-22,you kill me,4000000,2426851,3858964,2007,1432113,youkillme20070622,you kill me2007
20,2011-06-17,the art of getting by,4000000,1430241,1989035,2011,558794,theartofgettingby20110617,the art of getting by2011
21,2005-09-16,thumbsucker,4000000,1328679,1919197,2005,590518,thumbsucker20050916,thumbsucker2005
22,2011-09-23,red state,4000000,1065429,1983596,2011,918167,redstate20110923,red state2011
23,2005-09-30,mirrormask,4000000,864959,973613,2005,108654,mirrormask20050930,mirrormask2005
25,2012-10-17,holy motors,4000000,641054,4230426,2012,3589372,holymotors20121017,holy motors2012
26,2014-06-13,the signal,4000000,600896,2665322,2014,2064426,thesignal20140613,the signal2014
27,2003-02-28,poolhall junkies,4000000,563711,563711,2003,0,poolhalljunkies20030228,poolhall junkies2003
29,2014-03-07,the face of love,4000000,385069,1158877,2014,773808,thefaceoflove20140307,the face of love2014
30,2014-04-11,joe,4000000,373375,373375,2014,0,joe20140411,joe2014
33,2009-05-08,adoration,4000000,294244,384244,2009,90000,adoration20090508,adoration2009
34,2000-08-04,psycho beach party,4000000,267972,267972,2000,0,psychobeachparty20000804,psycho beach party2000
35,2019-06-07,late night,4000000,246305,246305,2019,0,latenight20190607,late night2019
36,2000-01-28,the big tease,4000000,185577,185577,2000,0,thebigtease20000128,the big tease2000
37,2017-08-25,polina danser sa vie,4000000,165203,953314,2017,788111,polinadansersavie20170825,polina danser sa vie2017
38,2015-04-10,desert dancer,4000000,155271,596335,2015,441064,desertdancer20150410,desert dancer2015
39,2015-01-30,"guten tag, ramon",4000000,154356,4854356,2015,4700000,gutentagramon20150130,"guten tag, ramon2015"
40,2003-07-25,mondays in the sun,4000000,146402,146402,2003,0,mondaysinthesun20030725,mondays in the sun2003
41,2015-06-19,manglehorn,4000000,132270,797439,2015,665169,manglehorn20150619,manglehorn2015
42,2010-04-02,tau ming chong,4000000,129078,38899792,2010,38770714,taumingchong20100402,tau ming chong2010
43,2011-04-01,trust,4000000,120016,120016,2011,0,trust20110401,trust2011
44,2000-12-22,an everlasting piece,4000000,75078,75078,2000,0,aneverlastingpiece20001222,an everlasting piece2000
47,2011-04-22,stake land,4000000,33245,679482,2011,646237,stakeland20110422,stake land2011
48,2015-02-27,praia do futuro,4000000,20620,760678,2015,740058,praiadofuturo20150227,praia do futuro2015
49,2002-12-27,sonny,4000000,17639,17639,2002,0,sonny20021227,sonny2002
51,2014-04-18,13 sins,4000000,9134,47552,2014,38418,13sins20140418,13 sins2014
52,2011-11-18,another happy day,4000000,9120,978527,2011,969407,anotherhappyday20111118,another happy day2011
53,2013-02-22,inescapable,4000000,4327,4327,2013,0,inescapable20130222,inescapable2013
54,2017-12-31,perfectos desconocidos,4000000,0,31166312,2017,31166312,perfectosdesconocidos20171231,perfectos desconocidos2017
55,2013-12-31,geograf globus propil,4000000,0,4454853,2013,4454853,geografglobuspropil20131231,geograf globus propil2013
56,2012-03-20,a lonely place to die,4000000,0,442550,2012,442550,alonelyplacetodie20120320,a lonely place to die2012
57,2003-12-31,nothing,4000000,0,63180,2003,63180,nothing20031231,nothing2003
58,2012-06-01,the loved ones,4000000,0,12302,2012,12302,thelovedones20120601,the loved ones2012
61,2008-08-26,purple violets,4000000,0,0,2008,0,purpleviolets20080826,purple violets2008
62,2012-11-09,replicas,4000000,0,0,2012,0,replicas20121109,replicas2012
63,2012-12-31,the helpers,4000000,0,0,2012,0,thehelpers20121231,the helpers2012
64,2015-12-31,the veil,4000000,0,0,2015,0,theveil20151231,the veil2015
65,2014-07-11,the perfect wave,4000000,0,0,2014,0,theperfectwave20140711,the perfect wave2014
66,2012-12-31,how to fall in love,4000000,0,0,2012,0,howtofallinlove20121231,how to fall in love2012
67,2015-09-08,chain of command,4000000,0,0,2015,0,chainofcommand20150908,chain of command2015
72,2011-01-14,down for life,3800000,41914,41914,2011,0,downforlife20110114,down for life2011
73,2010-04-30,the good heart,3800000,20930,340930,2010,320000,thegoodheart20100430,the good heart2010
75,2018-10-05,hevi reissu,3800000,10153,10153,2018,0,hevireissu20181005,hevi reissu2018
78,2006-08-11,casa de areia,3750000,539285,1178175,2006,638890,casadeareia20060811,casa de areia2006
79,2010-11-05,four lions,3750000,310007,2436111,2010,2126104,fourlions20101105,four lions2010
80,2010-02-19,defendor,3750000,44462,44462,2010,0,defendor20100219,defendor2010
83,2006-11-21,the history boys,3700000,2730296,13447998,2006,10717702,thehistoryboys20061121,the history boys2006
84,2006-11-03,unknown,3700000,26403,3355048,2006,3328645,unknown20061103,unknown2006
86,2008-10-10,billy: the early years of billy graham,3600000,320896,320896,2008,0,billytheearlyyearsofbillygraham20081010,billy: the early years of billy graham2008
87,2017-12-31,utã¸ya 22. juli,3600000,0,173156,2017,173156,utãya22juli20171231,utã¸ya 22. juli2017
91,2018-04-13,truth or dare,3500000,41411015,95127344,2018,53716329,truthordare20180413,truth or dare2018
94,2016-02-19,the witch,3500000,25138705,40454520,2016,15315815,thewitch20160219,the witch2016
95,2018-02-02,winchester,3500000,25091816,44378040,2018,19286224,winchester20180202,winchester2018
96,2002-12-06,empire,3500000,17504595,18495444,2002,990849,empire20021206,empire2002
97,2013-02-22,dark skies,3500000,17418667,27704111,2013,10285444,darkskies20130222,dark skies2013
98,2018-01-19,forever my girl,3500000,16376066,16376066,2018,0,forevermygirl20180119,forever my girl2018
8,2010-04-16,el secreto de sus ojos,3500000,6391436,40527719,2010,34136283,elsecretodesusojos20100416,el secreto de sus ojos2010
11,2018-05-18,first reformed,3500000,3448256,3874772,2018,426516,firstreformed20180518,first reformed2018
12,2001-06-29,pootie tang,3500000,3293258,3293258,2001,0,pootietang20010629,pootie tang2001
13,2016-12-02,believe,3500000,890303,890303,2016,0,believe20161202,believe2016
14,2000-04-19,la otra conquista,3500000,886410,886410,2000,0,laotraconquista20000419,la otra conquista2000
15,2016-09-30,american honey,3500000,663247,2611750,2016,1948503,americanhoney20160930,american honey2016
16,2016-03-18,the bronze,3500000,615816,615816,2016,0,thebronze20160318,the bronze2016
17,2011-06-10,trolljegeren,3500000,253444,5706638,2011,5453194,trolljegeren20110610,trolljegeren2011
18,2007-09-14,ira and abby,3500000,221096,221096,2007,0,iraandabby20070914,ira and abby2007
19,2016-01-08,the masked saint,3500000,182695,182695,2016,0,themaskedsaint20160108,the masked saint2016
20,2006-02-17,winter passing,3500000,107492,113783,2006,6291,winterpassing20060217,winter passing2006
21,2005-03-25,d.e.b.s.,3500000,96793,96793,2005,0,debs20050325,d.e.b.s.2005
22,2016-06-03,time to choose,3500000,29233,29233,2016,0,timetochoose20160603,time to choose2016
23,2009-06-26,surveillance,3500000,27349,1396395,2009,1369046,surveillance20090626,surveillance2009
25,2011-12-31,the kick,3500000,0,40622,2011,40622,thekick20111231,the kick2011
26,2009-06-30,the betrayed,3500000,0,0,2009,0,thebetrayed20090630,the betrayed2009
27,2006-10-01,the secret,3500000,0,0,2006,0,thesecret20061001,the secret2006
28,2011-06-28,2:13,3500000,0,0,2011,0,21320110628,2:132011
29,2013-01-29,"batman: the dark knight returns, part 2",3500000,0,0,2013,0,batmanthedarkknightreturnspart220130129,"batman: the dark knight returns, part 22013"
30,2014-03-11,in the name of the king iii,3500000,0,0,2014,0,inthenameofthekingiii20140311,in the name of the king iii2014
31,2014-03-04,wicked blood,3500000,0,0,2014,0,wickedblood20140304,wicked blood2014
32,2015-06-05,dawn patrol,3500000,0,0,2015,0,dawnpatrol20150605,dawn patrol2015
33,2013-05-17,jagten,3450000,687185,18309793,2013,17622608,jagten20130517,jagten2013
34,2015-09-01,lords of london,3440000,0,0,2015,0,lordsoflondon20150901,lords of london2015
35,2005-06-24,la marche de l'empereur,3400000,77437223,133276359,2005,55839136,lamarchedelempereur20050624,la marche de l'empereur2005
37,2011-10-21,margin call,3400000,5353586,20433227,2011,15079641,margincall20111021,margin call2011
38,2008-09-26,choke,3400000,2926565,4124277,2008,1197712,choke20080926,choke2008
39,2004-04-23,l\'incomparable mademoiselle c.,3400000,493905,493905,2004,0,lincomparablemademoisellec20040423,l\'incomparable mademoiselle c.2004
40,2008-07-11,august,3400000,12636,12636,2008,0,august20080711,august2008
41,2015-03-03,to write love on her arms,3400000,0,0,2015,0,towriteloveonherarms20150303,to write love on her arms2015
43,2014-10-10,whiplash,3300000,13092006,38969037,2014,25877031,whiplash20141010,whiplash2014
44,2007-10-26,bella,3300000,8093373,12405473,2007,4312100,bella20071026,bella2007
45,2003-01-17,cidade de deus,3300000,7563397,32059295,2003,24495898,cidadededeus20030117,cidade de deus2003
46,2000-05-05,human traffic,3300000,104257,5422740,2000,5318483,humantraffic20000505,human traffic2000
47,2006-12-29,the dead girl,3300000,19875,19875,2006,0,thedeadgirl20061229,the dead girl2006
48,2015-01-20,the opposite sex,3300000,0,50206,2015,50206,theoppositesex20150120,the opposite sex2015
51,2009-01-30,entre les murs,3250000,3766810,34114067,2009,30347257,entrelesmurs20090130,entre les murs2009
54,2018-07-06,sorry to bother you,3200000,17493096,18285560,2018,792464,sorrytobotheryou20180706,sorry to bother you2018
56,2004-07-16,maria full of grace,3200000,6529624,14441158,2004,7911534,mariafullofgrace20040716,maria full of grace2004
57,2011-06-03,beginners,3200000,5790894,14314407,2011,8523513,beginners20110603,beginners2011
58,2016-04-22,the meddler,3200000,4267219,5526942,2016,1259723,themeddler20160422,the meddler2016
59,2009-07-29,adam,3200000,2283291,2834485,2009,551194,adam20090729,adam2009
60,2006-09-22,feast,3200000,56131,690872,2006,634741,feast20060922,feast2006
63,2013-04-12,antiviral,3100000,0,123407,2013,123407,antiviral20130412,antiviral2013
65,2010-10-20,paranormal activity 2,3000000,84752907,177512032,2010,92759125,paranormalactivity220101020,paranormal activity 22010
66,2015-08-28,war room,3000000,67790117,73975239,2015,6185122,warroom20150828,war room2015
67,2013-06-07,the purge,3000000,64473115,91266581,2013,26793466,thepurge20130607,the purge2013
69,2012-10-12,sinister,3000000,48086903,87727807,2012,39640904,sinister20121012,sinister2012
70,2000-08-18,the original kings of comedy,3000000,38168022,38236338,2000,68316,theoriginalkingsofcomedy20000818,the original kings of comedy2000
75,2002-10-11,bowling for columbine,3000000,21576018,58240487,2002,36664469,bowlingforcolumbine20021011,bowling for columbine2002
80,2002-08-02,martin lawrence live: runteldat,3000000,19184820,19184820,2002,0,martinlawrenceliverunteldat20020802,martin lawrence live: runteldat2002
84,2001-04-06,pokemon 3: the movie,3000000,17052128,68452128,2001,51400000,pokemon3themovie20010406,pokemon 3: the movie2001
89,2018-06-01,upgrade,3000000,11977130,16553285,2018,4576155,upgrade20180601,upgrade2018
90,2006-03-03,dave chappelle's block party,3000000,11718595,12051924,2006,333329,davechappellesblockparty20060303,dave chappelle's block party2006
93,2009-05-08,next day air,3000000,10027047,10172519,2009,145472,nextdayair20090508,next day air2009
98,2001-08-08,the deep end,3000000,8823109,9981635,2001,1158526,thedeepend20010808,the deep end2001
99,2013-05-24,before midnight,3000000,8110621,23251930,2013,15141309,beforemidnight20130524,before midnight2013
1,2009-07-31,the collector,3000000,7712114,10473836,2009,2761722,thecollector20090731,the collector2009
3,2017-10-27,let there be light,3000000,7233471,7241309,2017,7838,lettherebelight20171027,let there be light2017
4,2006-04-07,phat girlz,3000000,7061128,7301115,2006,239987,phatgirlz20060407,phat girlz2006
5,2004-10-01,woman thou art loosed,3000000,6879730,6879730,2004,0,womanthouartloosed20041001,woman thou art loosed2004
6,2002-10-18,real women have curves,3000000,5853194,7777790,2002,1924596,realwomenhavecurves20021018,real women have curves2002
8,2006-04-28,water,3000000,5529144,11322573,2006,5793429,water20060428,water2006
9,2016-07-22,donât think twice,3000000,4417983,4417983,2016,0,donâtthinktwice20160722,donât think twice2016
10,2016-06-24,swiss army man,3000000,4210454,5837111,2016,1626657,swissarmyman20160624,swiss army man2016
11,2000-04-14,east is east,3000000,4170647,30438635,2000,26267988,eastiseast20000414,east is east2000
12,2000-09-01,whipped,3000000,4142507,4142507,2000,0,whipped20000901,whipped2000
14,2013-05-17,frances ha,3000000,4067398,11262769,2013,7195371,francesha20130517,frances ha2013
15,2010-04-30,please give,3000000,4033574,4570178,2010,536604,pleasegive20100430,please give2010
20,2002-05-24,thirteen conversations about one thing,3000000,3287435,3705923,2002,418488,thirteenconversationsaboutonething20020524,thirteen conversations about one thing2002
21,2016-04-22,compadres,3000000,3127773,7445044,2016,4317271,compadres20160422,compadres2016
24,2006-02-24,tsotsi,3000000,2912606,11537539,2006,8624933,tsotsi20060224,tsotsi2006
25,2010-04-09,letters to god,3000000,2848587,3237452,2010,388865,letterstogod20100409,letters to god2010
27,2003-04-04,dysfunktional family,3000000,2255000,2255000,2003,0,dysfunktionalfamily20030404,dysfunktional family2003
28,2014-09-19,tusk,3000000,1821983,1887554,2014,65571,tusk20140919,tusk2014
29,2017-05-12,the wall,3000000,1803064,4495262,2017,2692198,thewall20170512,the wall2017
30,2003-10-24,elephant,3000000,1266955,10051516,2003,8784561,elephant20031024,elephant2003
31,2012-04-06,damsels in distress,3000000,1007535,1324299,2012,316764,damselsindistress20120406,damsels in distress2012
32,2005-03-25,oldboy,3000000,707391,6239723,2005,5532332,oldboy20050325,oldboy2005
33,2011-05-06,hobo with a shotgun,3000000,703372,834953,2011,131581,hobowithashotgun20110506,hobo with a shotgun2011
34,2015-05-08,the d train,3000000,669688,772366,2015,102678,thedtrain20150508,the d train2015
35,2012-09-07,bachelorette,3000000,446770,12577401,2012,12130631,bachelorette20120907,bachelorette2012
36,2010-01-15,fish tank,3000000,374675,5922292,2010,5547617,fishtank20100115,fish tank2010
37,2008-09-05,everybody wants to be italian,3000000,351416,351416,2008,0,everybodywantstobeitalian20080905,everybody wants to be italian2008
38,2011-09-09,creature,3000000,331000,331000,2011,0,creature20110909,creature2011
39,2016-12-09,the bounce back,3000000,321910,421404,2016,99494,thebounceback20161209,the bounce back2016
41,2006-10-06,love's abiding joy,3000000,252726,252726,2006,0,lovesabidingjoy20061006,love's abiding joy2006
43,2010-10-01,chain letter,3000000,205842,1022453,2010,816611,chainletter20101001,chain letter2010
44,2012-03-02,tim and eric's billion dollar movie,3000000,201436,223652,2012,22216,timandericsbilliondollarmovie20120302,tim and eric's billion dollar movie2012
45,2007-11-09,holly,3000000,163069,163069,2007,0,holly20071109,holly2007
46,2010-03-26,the eclipse,3000000,133411,133411,2010,0,theeclipse20100326,the eclipse2010
47,2008-03-21,the grand,3000000,115879,115879,2008,0,thegrand20080321,the grand2008
48,2006-03-17,sommersturm,3000000,95204,95204,2006,0,sommersturm20060317,sommersturm2006
49,2014-08-15,fort mccoy,3000000,78948,78948,2014,0,fortmccoy20140815,fort mccoy2014
51,2000-10-13,just looking,3000000,39852,39852,2000,0,justlooking20001013,just looking2000
52,2015-09-04,before we go,3000000,37151,483938,2015,446787,beforewego20150904,before we go2015
53,2012-01-13,the divide,3000000,18000,156362,2012,138362,thedivide20120113,the divide2012
54,2011-09-09,tanner hall,3000000,5073,5073,2011,0,tannerhall20110909,tanner hall2011
55,2005-09-30,my big fat independent movie,3000000,4655,4655,2005,0,mybigfatindependentmovie20050930,my big fat independent movie2005
56,2017-10-10,demonic,3000000,0,4668109,2017,4668109,demonic20171010,demonic2017
57,2008-04-15,ã l\'intã©rieur,3000000,0,895932,2008,895932,ãlintãrieur20080415,ã l\'intã©rieur2008
58,2014-06-27,they came together,3000000,0,82780,2014,82780,theycametogether20140627,they came together2014
59,2013-05-21,open road,3000000,0,47469,2013,47469,openroad20130521,open road2013
61,2010-10-01,barry munday,3000000,0,0,2010,0,barrymunday20101001,barry munday2010
62,2009-12-31,the deported,3000000,0,0,2009,0,thedeported20091231,the deported2009
63,2009-12-31,chicago overcoat,3000000,0,0,2009,0,chicagoovercoat20091231,chicago overcoat2009
64,2011-09-13,never back down 2: the beatdown,3000000,0,0,2011,0,neverbackdown2thebeatdown20110913,never back down 2: the beatdown2011
65,2015-12-31,awol-72,3000000,0,0,2015,0,awol7220151231,awol-722015
66,2013-01-15,30 nights of paranormal activity with the devil inside the girl with the dragon tattoo,3000000,0,0,2013,0,30nightsofparanormalactivitywiththedevilinsidethegirlwiththedragontattoo20130115,30 nights of paranormal activity with the devil inside the girl with the dragon tattoo2013
67,2015-02-06,enter the dangerous mind,3000000,0,0,2015,0,enterthedangerousmind20150206,enter the dangerous mind2015
68,2015-03-17,something wicked,3000000,0,0,2015,0,somethingwicked20150317,something wicked2015
70,2014-10-27,iguana,3000000,0,0,2014,0,iguana20141027,iguana2014
71,2009-12-31,four single fathers,3000000,0,0,2009,0,foursinglefathers20091231,four single fathers2009
72,2015-08-14,amnesiac,3000000,0,0,2015,0,amnesiac20150814,amnesiac2015
73,2015-12-31,unnatural,3000000,0,0,2015,0,unnatural20151231,unnatural2015
74,2015-12-11,close range,3000000,0,0,2015,0,closerange20151211,close range2015
79,2006-03-24,boynton beach club,2900000,3127472,3127472,2006,0,boyntonbeachclub20060324,boynton beach club2006
80,2010-10-01,freakonomics,2900000,101270,172867,2010,71597,freakonomics20101001,freakonomics2010
81,2011-08-19,griff the invisible,2900000,20778,25935,2011,5157,grifftheinvisible20110819,griff the invisible2011
83,2005-06-10,high tension,2850000,3681066,6435262,2005,2754196,hightension20050610,high tension2005
86,2005-07-22,hustle & flow,2800000,22202809,23591783,2005,1388974,hustleflow20050722,hustle & flow2005
88,2006-09-15,artie lange's beer league,2800000,475000,475000,2006,0,artielangesbeerleague20060915,artie lange's beer league2006
90,2008-02-15,diary of the dead,2750000,952620,5394447,2008,4441827,diaryofthedead20080215,diary of the dead2008
93,2018-10-26,indivisible,2700000,3511417,3588305,2018,76888,indivisible20181026,indivisible2018
94,2006-09-01,lage raho munna bhai,2700000,2217561,31517561,2006,29300000,lagerahomunnabhai20060901,lage raho munna bhai2006
95,2015-12-31,sardaar ji,2700000,0,8200000,2015,8200000,sardaarji20151231,sardaar ji2015
96,2008-12-31,rejsen til saturn,2700000,0,5377665,2008,5377665,rejsentilsaturn20081231,rejsen til saturn2008
3,2014-05-02,ida,2600000,3827060,15298355,2014,11471295,ida20140502,ida2014
5,2004-07-09,riding giants,2600000,2276368,3292333,2004,1015965,ridinggiants20040709,riding giants2004
6,2008-12-12,los cronocrã­menes,2600000,39127,564474,2008,525347,loscronocrãmenes20081212,los cronocrã­menes2008
7,2011-12-31,la cara oculta,2600000,0,7033931,2011,7033931,lacaraoculta20111231,la cara oculta2011
8,2007-12-07,timber falls,2600000,0,71248,2007,71248,timberfalls20071207,timber falls2007
9,2008-12-31,silver medalist,2600000,0,0,2008,0,silvermedalist20081231,silver medalist2008
10,2011-04-01,"fat, sick & nearly dead",2600000,0,0,2011,0,fatsicknearlydead20110401,"fat, sick & nearly dead2011"
12,2013-01-11,a haunted house,2500000,40041683,59922558,2013,19880875,ahauntedhouse20130111,a haunted house2013
13,2012-07-13,2016: obamaâs america,2500000,33349941,33349941,2012,0,2016obamaâsamerica20120713,2016: obamaâs america2012
14,2013-07-03,kevin hart: let me explain,2500000,32244051,32327255,2013,83204,kevinhartletmeexplain20130703,kevin hart: let me explain2013
15,2004-07-28,garden state,2500000,26782316,36028802,2004,9246486,gardenstate20040728,garden state2004
19,2008-10-01,religulous,2500000,13011160,13881317,2008,870157,religulous20081001,religulous2008
22,2013-08-02,the spectacular now,2500000,6852971,6916951,2013,63980,thespectacularnow20130802,the spectacular now2013
25,2016-06-24,hunt for the wilderpeople,2500000,5205471,23845533,2016,18640062,huntforthewilderpeople20160624,hunt for the wilderpeople2016
26,2012-08-17,robot & frank,2500000,3317468,4934356,2012,1616888,robotfrank20120817,robot & frank2012
27,2003-10-03,sur le seuil,2500000,2013052,2013052,2003,0,surleseuil20031003,sur le seuil2003
28,2000-06-16,jesus' son,2500000,1282084,1687548,2000,405464,jesusson20000616,jesus' son2000
29,2005-05-27,saving face,2500000,1187266,1269705,2005,82439,savingface20050527,saving face2005
30,2008-06-20,brick lane,2500000,1094998,3838486,2008,2743488,bricklane20080620,brick lane2008
31,2013-03-01,the lost medallion: the adventures of billy stone,2500000,549632,549632,2013,0,thelostmedalliontheadventuresofbillystone20130301,the lost medallion: the adventures of billy stone2013
32,2003-09-26,my life without me,2500000,432360,12267275,2003,11834915,mylifewithoutme20030926,my life without me2003
33,2006-03-31,marilyn hotchkiss' ballroom dancing and charm school,2500000,349132,497195,2006,148063,marilynhotchkissballroomdancingandcharmschool20060331,marilyn hotchkiss' ballroom dancing and charm school2006
34,2011-04-01,super,2500000,327716,593933,2011,266217,super20110401,super2011
35,2008-11-14,fuel,2500000,174255,174255,2008,0,fuel20081114,fuel2008
36,2010-04-09,valley of the hearts delight,2500000,118666,118666,2010,0,valleyoftheheartsdelight20100409,valley of the hearts delight2010
37,2008-10-31,the other end of the line,2500000,115504,507446,2008,391942,theotherendoftheline20081031,the other end of the line2008
38,2010-06-18,8: the mormon proposition,2500000,100280,100280,2010,0,8themormonproposition20100618,8: the mormon proposition2010
39,2009-04-17,sleep dealer,2500000,80136,108907,2009,28771,sleepdealer20090417,sleep dealer2009
40,2007-08-24,eye of the dolphin,2500000,72210,72260,2007,50,eyeofthedolphin20070824,eye of the dolphin2007
41,2013-08-16,underdogs,2500000,35017,1392649,2013,1357632,underdogs20130816,underdogs2013
42,2000-09-08,anatomie,2500000,9598,9598,2000,0,anatomie20000908,anatomie2000
43,2009-12-31,the calling,2500000,0,0,2009,0,thecalling20091231,the calling2009
44,2013-06-21,alien uprising,2500000,0,0,2013,0,alienuprising20130621,alien uprising2013
45,2010-12-31,christmas mail,2500000,0,0,2010,0,christmasmail20101231,christmas mail2010
46,2015-07-03,stung,2500000,0,0,2015,0,stung20150703,stung2015
47,2017-09-01,sky sharks,2500000,0,0,2017,0,skysharks20170901,sky sharks2017
48,2015-10-13,8 days,2500000,0,0,2015,0,8days20151013,8 days2015
49,2016-09-02,antibirth,2500000,0,0,2016,0,antibirth20160902,antibirth2016
50,2016-02-02,the rise of the krays,2500000,0,0,2016,0,theriseofthekrays20160202,the rise of the krays2016
51,2014-12-31,not safe for work,2500000,0,0,2014,0,notsafeforwork20141231,not safe for work2014
52,2011-05-13,go for it!,2450000,180237,182358,2011,2121,goforit20110513,go for it!2011
54,2007-01-05,thr3e,2400000,1008849,1420418,2007,411569,thr3e20070105,thr3e2007
55,2006-09-01,idiocracy,2400000,444093,500296,2006,56203,idiocracy20060901,idiocracy2006
56,2009-12-31,niktã©,2400000,0,1333891,2009,1333891,niktã20091231,niktã©2009
57,2014-11-14,always woodstock,2400000,0,0,2014,0,alwayswoodstock20141114,always woodstock2014
58,2007-07-25,this is england,2380000,327919,8739576,2007,8411657,thisisengland20070725,this is england2007
60,2015-03-20,do you believe?,2300000,12985600,14304931,2015,1319331,doyoubelieve20150320,do you believe?2015
63,2014-09-05,frontera,2300000,59696,59696,2014,0,frontera20140905,frontera2014
64,2011-08-26,redemption road,2300000,29384,29384,2011,0,redemptionroad20110826,redemption road2011
65,2015-04-15,the toxic avenger part ii,2300000,0,0,2015,0,thetoxicavengerpartii20150415,the toxic avenger part ii2015
66,2016-01-19,eden,2300000,0,0,2016,0,eden20160119,eden2016
73,2007-02-09,the last sin eater,2200000,388390,388390,2007,0,thelastsineater20070209,the last sin eater2007
74,2008-12-31,impact point,2200000,0,0,2008,0,impactpoint20081231,impact point2008
76,2005-12-31,chicken tikka masala,2160000,0,37865,2005,37865,chickentikkamasala20051231,chicken tikka masala2005
77,2008-10-07,jack brooks: monster slayer,2150000,0,0,2008,0,jackbrooksmonsterslayer20081007,jack brooks: monster slayer2008
79,2001-07-13,bully,2100000,881824,1381824,2001,500000,bully20010713,bully2001
80,2002-05-29,elling,2100000,313436,313436,2002,0,elling20020529,elling2002
81,2016-10-16,mi america,2100000,3330,3330,2016,0,miamerica20161016,mi america2016
82,2009-07-14,[rec],2100000,0,23266821,2009,23266821,rec20090714,[rec]2009
83,2012-12-31,infected,2100000,0,0,2012,0,infected20121231,infected2012
84,2010-12-31,lies in plain sight,2100000,0,0,2010,0,liesinplainsight20101231,lies in plain sight2010
85,2015-10-06,the timber,2100000,0,0,2015,0,thetimber20151006,the timber2015
86,2016-01-19,sharkskin,2100000,0,0,2016,0,sharkskin20160119,sharkskin2016
87,2011-09-30,courageous,2000000,34522221,35185884,2011,663663,courageous20110930,courageous2011
94,2015-03-13,it follows,2000000,14674077,23250755,2015,8576678,itfollows20150313,it follows2015
95,2018-07-13,eighth grade,2000000,13539710,14341016,2018,801306,eighthgrade20180713,eighth grade2018
97,2012-03-09,silent house,2000000,12739737,16610760,2012,3871023,silenthouse20120309,silent house2012
99,2007-02-09,das leben der anderen,2000000,11284657,81197047,2007,69912390,daslebenderanderen20070209,das leben der anderen2007
100,2016-04-08,hardcore henry,2000000,9252038,17187434,2016,7935396,hardcorehenry20160408,hardcore henry2016
6,2003-11-26,les triplettes de belleville,2000000,7301288,17403168,2003,10101880,lestriplettesdebelleville20031126,les triplettes de belleville2003
8,2010-06-11,winter's bone,2000000,6531503,16131551,2010,9600048,wintersbone20100611,winter's bone2010
9,2014-10-10,meet the mormons,2000000,6047363,6049171,2014,1808,meetthemormons20141010,meet the mormons2014
10,2003-08-15,american splendor,2000000,6003587,8685632,2003,2682045,americansplendor20030815,american splendor2003
11,2017-10-06,the florida project,2000000,5904366,11295324,2017,5390958,thefloridaproject20171006,the florida project2017
12,2017-08-25,all saints,2000000,5802208,5941994,2017,139786,allsaints20170825,all saints2017
13,2004-07-02,before sunset,2000000,5792822,11217346,2004,5424524,beforesunset20040702,before sunset2004
14,2001-03-30,amores perros,2000000,5383834,20883834,2001,15500000,amoresperros20010330,amores perros2001
15,2003-08-20,thirteen,2000000,4601043,9505996,2003,4904953,thirteen20030820,thirteen2003
16,2004-01-23,touching the void,2000000,4593598,15396525,2004,10802927,touchingthevoid20040123,touching the void2004
17,2010-10-08,inside job,2000000,4311834,7799257,2010,3487423,insidejob20101008,inside job2010
19,2005-06-17,me and you and everyone we know,2000000,3885134,9615464,2005,5730330,meandyouandeveryoneweknow20050617,me and you and everyone we know2005
20,2015-08-28,we are your friends,2000000,3591417,10153415,2015,6561998,weareyourfriends20150828,we are your friends2015
21,2006-11-10,harsh times,2000000,3337931,6225304,2006,2887373,harshtimes20061110,harsh times2006
22,2000-03-03,ghost dog: the way of the samurai,2000000,3330230,10672492,2000,7342262,ghostdogthewayofthesamurai20000303,ghost dog: the way of the samurai2000
23,2015-09-18,captive,2000000,2583301,2791973,2015,208672,captive20150918,captive2015
24,2002-08-02,full frontal,2000000,2512846,3438804,2002,925958,fullfrontal20020802,full frontal2002
25,2018-06-08,hearts beat loud,2000000,2386254,2420962,2018,34708,heartsbeatloud20180608,hearts beat loud2018
26,2017-01-20,the resurrection of gavin stone,2000000,2303792,2303792,2017,0,theresurrectionofgavinstone20170120,the resurrection of gavin stone2017
27,2008-12-25,waltz with bashir,2000000,2283849,13912289,2008,11628440,waltzwithbashir20081225,waltz with bashir2008
28,2006-06-28,strangers with candy,2000000,2072645,2077844,2006,5199,strangerswithcandy20060628,strangers with candy2006
31,2006-10-04,shortbus,2000000,1985292,1985292,2006,0,shortbus20061004,shortbus2006
32,2008-05-02,son of rambow: a home movie,2000000,1785505,11263263,2008,9477758,sonoframbowahomemovie20080502,son of rambow: a home movie2008
33,2003-09-12,"the book of mormon movie, volume 1: the journey",2000000,1660865,1660865,2003,0,thebookofmormonmovievolume1thejourney20030912,"the book of mormon movie, volume 1: the journey2003"
34,2000-05-12,hamlet,2000000,1577287,2419669,2000,842382,hamlet20000512,hamlet2000
35,2015-08-07,the diary of a teenage girl,2000000,1477002,2279959,2015,802957,thediaryofateenagegirl20150807,the diary of a teenage girl2015
36,2007-07-27,no end in sight,2000000,1433319,1433319,2007,0,noendinsight20070727,no end in sight2007
37,2014-04-25,locke,2000000,1370646,2088390,2014,717744,locke20140425,locke2014
39,2007-09-07,in the shadow of the moon,2000000,1134358,2175587,2007,1041229,intheshadowofthemoon20070907,in the shadow of the moon2007
40,2011-04-08,meek's cutoff,2000000,977772,1869928,2011,892156,meekscutoff20110408,meek's cutoff2011
41,2014-11-28,the babadook,2000000,950792,7482387,2014,6531595,thebabadook20141128,the babadook2014
42,2005-02-11,inside deep throat,2000000,691880,691880,2005,0,insidedeepthroat20050211,inside deep throat2005
43,2001-09-28,dinner rush,2000000,638227,1075504,2001,437277,dinnerrush20010928,dinner rush2001
44,2010-09-24,the virginity hit,2000000,636706,636706,2010,0,thevirginityhit20100924,the virginity hit2010
47,2005-04-15,house of d,2000000,388532,466106,2005,77574,houseofd20050415,house of d2005
48,2008-01-18,teeth,2000000,347578,2350641,2008,2003063,teeth20080118,teeth2008
50,2006-09-08,sherrybaby,2000000,199176,759504,2006,560328,sherrybaby20060908,sherrybaby2006
51,2015-02-13,the last five years,2000000,147299,205298,2015,57999,thelastfiveyears20150213,the last five years2015
53,2000-05-26,hum to mohabbt karega,2000000,121807,121807,2000,0,humtomohabbtkarega20000526,hum to mohabbt karega2000
54,2005-04-15,it's all gone pete tong,2000000,120620,2226603,2005,2105983,itsallgonepetetong20050415,it's all gone pete tong2005
55,2010-01-29,saint john of las vegas,2000000,102645,102645,2010,0,saintjohnoflasvegas20100129,saint john of las vegas2010
57,2014-09-19,pump,2000000,72277,72277,2014,0,pump20140919,pump2014
58,2008-10-24,roadside romeo,2000000,55202,2046090,2008,1990888,roadsideromeo20081024,roadside romeo2008
59,2001-05-04,eureka,2000000,49388,76654,2001,27266,eureka20010504,eureka2001
60,2015-04-07,lost river,2000000,45431,2009644,2015,1964213,lostriver20150407,lost river2015
61,2003-07-18,this thing of ours,2000000,37227,37227,2003,0,thisthingofours20030718,this thing of ours2003
62,2015-10-09,knock knock,2000000,36336,6328516,2015,6292180,knockknock20151009,knock knock2015
63,2017-02-03,growing up smith,2000000,35312,35312,2017,0,growingupsmith20170203,growing up smith2017
64,2009-03-20,super capers,2000000,30955,30955,2009,0,supercapers20090320,super capers2009
66,2009-11-20,the missing person,2000000,17896,17896,2009,0,themissingperson20091120,the missing person2009
67,2012-10-19,the first time,2000000,17061,17061,2012,0,thefirsttime20121019,the first time2012
68,2006-02-10,london,2000000,12667,12667,2006,0,london20060210,london2006
69,2010-08-27,circle,2000000,10024,10024,2010,0,circle20100827,circle2010
70,2008-10-31,eden lake,2000000,7321,4294373,2008,4287052,edenlake20081031,eden lake2008
71,2010-06-11,jerusalema,2000000,7294,10679,2010,3385,jerusalema20100611,jerusalema2010
72,2006-06-23,say uncle,2000000,5361,5361,2006,0,sayuncle20060623,say uncle2006
73,2013-09-13,plush,2000000,3080,28864,2013,25784,plush20130913,plush2013
74,2012-10-26,the ghastly love of johnny x,2000000,2436,2436,2012,0,theghastlyloveofjohnnyx20121026,the ghastly love of johnny x2012
75,2009-12-29,lesbian vampire killers,2000000,0,3620902,2009,3620902,lesbianvampirekillers20091229,lesbian vampire killers2009
76,2011-09-09,grave encounters,2000000,0,2151887,2011,2151887,graveencounters20110909,grave encounters2011
77,2015-10-23,bone tomahawk,2000000,0,475846,2015,475846,bonetomahawk20151023,bone tomahawk2015
78,2004-12-10,freeze frame,2000000,0,105377,2004,105377,freezeframe20041210,freeze frame2004
79,2013-04-01,stitches,2000000,0,63555,2013,63555,stitches20130401,stitches2013
80,2015-12-31,"to be frank, sinatra at 100",2000000,0,926,2015,926,tobefranksinatraat10020151231,"to be frank, sinatra at 1002015"
82,2009-12-31,nine dead,2000000,0,0,2009,0,ninedead20091231,nine dead2009
83,2008-10-14,no man's land: the rise of reeker,2000000,0,0,2008,0,nomanslandtheriseofreeker20081014,no man's land: the rise of reeker2008
84,2007-07-07,rockaway,2000000,0,0,2007,0,rockaway20070707,rockaway2007
86,2015-03-17,the lady from shanghai,2000000,0,0,2015,0,theladyfromshanghai20150317,the lady from shanghai2015
87,2013-03-19,straight a's,2000000,0,0,2013,0,straightas20130319,straight a's2013
88,2012-03-30,the legend of hellâs gate: an american conspiracy,2000000,0,0,2012,0,thelegendofhellâsgateanamericanconspiracy20120330,the legend of hellâs gate: an american conspiracy2012
89,2012-12-31,highway,2000000,0,0,2012,0,highway20121231,highway2012
90,2013-02-08,small apartments,2000000,0,0,2013,0,smallapartments20130208,small apartments2013
91,2013-07-09,coffee town,2000000,0,0,2013,0,coffeetown20130709,coffee town2013
92,2014-12-31,lucky dog,2000000,0,0,2014,0,luckydog20141231,lucky dog2014
93,2001-12-31,pendulum,2000000,0,0,2001,0,pendulum20011231,pendulum2001
95,2008-09-23,slacker uprising,2000000,0,0,2008,0,slackeruprising20080923,slacker uprising2008
96,2015-03-20,the walking deceased,2000000,0,0,2015,0,thewalkingdeceased20150320,the walking deceased2015
97,2011-12-31,true bromance,2000000,0,0,2011,0,truebromance20111231,true bromance2011
98,2015-08-21,the curse of downers grove,2000000,0,0,2015,0,thecurseofdownersgrove20150821,the curse of downers grove2015
99,2015-12-31,wind walkers,2000000,0,0,2015,0,windwalkers20151231,wind walkers2015
100,2016-07-08,the dog lover,2000000,0,0,2016,0,thedoglover20160708,the dog lover2016
1,2015-12-01,shark lake,2000000,0,0,2015,0,sharklake20151201,shark lake2015
2,2010-09-24,buried,1987650,1044143,21270290,2010,20226147,buried20100924,buried2010
3,2015-04-21,the marine 4,1950000,0,0,2015,0,themarine420150421,the marine 42015
5,2008-07-25,man on wire,1900000,2962242,5617067,2008,2654825,manonwire20080725,man on wire2008
6,2010-10-08,nowhere boy,1900000,1445366,7785229,2010,6339863,nowhereboy20101008,nowhere boy2010
7,2003-07-11,northfork,1900000,1420578,1445140,2003,24562,northfork20030711,northfork2003
8,2015-04-24,brotherly love,1900000,478595,478595,2015,0,brotherlylove20150424,brotherly love2015
9,2011-06-03,submarine,1900000,467602,4581937,2011,4114335,submarine20110603,submarine2011
10,2010-04-09,the square,1900000,406216,740932,2010,334716,thesquare20100409,the square2010
11,2013-02-08,abcd (any body can dance),1900000,222098,10137234,2013,9915136,abcdanybodycandance20130208,abcd (any body can dance)2013
12,2007-06-29,chacun sa nuit,1900000,18435,139317,2007,120882,chacunsanuit20070629,chacun sa nuit2007
13,2013-07-26,stranded,1900000,0,285593,2013,285593,stranded20130726,stranded2013
14,2015-12-31,vaalu,1900000,0,12444,2015,12444,vaalu20151231,vaalu2015
15,2010-08-27,the last exorcism,1800000,41034350,70165900,2010,29131550,thelastexorcism20100827,the last exorcism2010
18,2012-06-27,beasts of the southern wild,1800000,12795746,23265132,2012,10469386,beastsofthesouthernwild20120627,beasts of the southern wild2012
23,2002-11-15,el crimen de padre amaro,1800000,5719000,5719000,2002,0,elcrimendepadreamaro20021115,el crimen de padre amaro2002
24,2001-06-15,songcatcher,1800000,3050934,3050934,2001,0,songcatcher20010615,songcatcher2001
25,2011-08-23,higher ground,1800000,841056,842693,2011,1637,higherground20110823,higher ground2011
26,2011-04-22,pom wonderful presents: the greatest movie ever sold,1800000,638476,783733,2011,145257,pomwonderfulpresentsthegreatestmovieeversold20110422,pom wonderful presents: the greatest movie ever sold2011
27,2005-01-07,travellers and magicians,1800000,506793,1322161,2005,815368,travellersandmagicians20050107,travellers and magicians2005
29,2009-12-31,deadline,1800000,0,0,2009,0,deadline20091231,deadline2009
30,2007-03-13,sublime,1800000,0,0,2007,0,sublime20070313,sublime2007
31,2012-02-03,dysfunctional friends,1800000,0,0,2012,0,dysfunctionalfriends20120203,dysfunctional friends2012
32,2013-12-31,independence daysaster,1800000,0,0,2013,0,independencedaysaster20131231,independence daysaster2013
33,2014-03-11,against the wild,1800000,0,0,2014,0,againstthewild20140311,against the wild2014
34,2015-10-20,beginnerâs guide to sex,1800000,0,0,2015,0,beginnerâsguidetosex20151020,beginnerâs guide to sex2015
36,2003-02-07,may,1750000,145540,634803,2003,489263,may20030207,may2003
37,2010-10-08,i spit on your grave,1750000,93051,1278471,2010,1185420,ispitonyourgrave20101008,i spit on your grave2010
38,2019-04-23,living dark: the story of ted the caver,1750000,0,0,2019,0,livingdarkthestoryoftedthecaver20190423,living dark: the story of ted the caver2019
39,2001-11-23,in the bedroom,1700000,35930604,42137871,2001,6207267,inthebedroom20011123,in the bedroom2001
40,2008-03-19,la misma luna,1700000,12590147,23271741,2008,10681594,lamismaluna20080319,la misma luna2008
42,2014-02-28,the lunchbox,1700000,4231500,12231500,2014,8000000,thelunchbox20140228,the lunchbox2014
43,2013-10-04,grace unplugged,1700000,2507159,2507159,2013,0,graceunplugged20131004,grace unplugged2013
45,2015-12-18,saul fia,1700000,1777043,9696537,2015,7919494,saulfia20151218,saul fia2015
46,2005-06-17,my summer of love,1700000,1000915,4727375,2005,3726460,mysummeroflove20050617,my summer of love2005
47,2005-06-24,yes,1700000,396035,661221,2005,265186,yes20050624,yes2005
48,2019-02-01,braid,1660000,0,80745,2019,80745,braid20190201,braid2019
54,2010-10-15,n-secure,1600000,2595644,2595644,2010,0,nsecure20101015,n-secure2010
55,2008-02-01,sukkar banat,1600000,1060591,14253760,2008,13193169,sukkarbanat20080201,sukkar banat2008
57,2006-01-27,bubble,1600000,145382,145382,2006,0,bubble20060127,bubble2006
58,2005-09-23,dil jo bhi kahey...,1600000,129319,129319,2005,0,diljobhikahey20050923,dil jo bhi kahey...2005
60,2014-09-26,two night stand,1600000,15600,868081,2014,852481,twonightstand20140926,two night stand2014
61,2005-11-04,i love your work,1600000,3264,3264,2005,0,iloveyourwork20051104,i love your work2005
63,2011-04-01,insidious,1500000,54009150,99870886,2011,45861736,insidious20110401,insidious2011
64,2016-10-21,moonlight,1500000,27854931,65245512,2016,37390581,moonlight20161021,moonlight2016
65,2003-09-12,cabin fever,1500000,21158188,30351664,2003,9193476,cabinfever20030912,cabin fever2003
66,2007-05-02,waitress,1500000,19097550,22217183,2007,3119633,waitress20070502,waitress2007
70,2018-03-23,unsane,1500000,7690044,14244931,2018,6554887,unsane20180323,unsane2018
72,2005-10-05,the squid and the whale,1500000,7372734,11191423,2005,3818689,thesquidandthewhale20051005,the squid and the whale2005
73,2002-03-13,kissing jessica stein,1500000,7025722,9345061,2002,2319339,kissingjessicastein20020313,kissing jessica stein2002
77,2013-07-26,the to do list,1500000,3491669,4128828,2013,637159,thetodolist20130726,the to do list2013
78,2013-02-01,the gatekeepers,1500000,2408553,2592308,2013,183755,thegatekeepers20130201,the gatekeepers2013
81,2016-10-21,iâm not ashamed,1500000,2082980,2082980,2016,0,iâmnotashamed20161021,iâm not ashamed2016
83,2002-04-19,nueve reinas,1500000,1222889,12412889,2002,11190000,nuevereinas20020419,nueve reinas2002
84,2013-04-19,the lords of salem,1500000,1165881,1541131,2013,375250,thelordsofsalem20130419,the lords of salem2013
85,2016-10-21,31,1500000,779820,922727,2016,142907,3120161021,312016
86,2005-03-25,the ballad of jack and rose,1500000,712294,1126258,2005,413964,theballadofjackandrose20050325,the ballad of jack and rose2005
87,2016-04-22,unsullied,1500000,510957,510957,2016,0,unsullied20160422,unsullied2016
89,2002-05-17,the believer,1500000,406035,1840248,2002,1434213,thebeliever20020517,the believer2002
90,2008-03-07,snow angels,1500000,402858,414404,2008,11546,snowangels20080307,snow angels2008
91,2001-08-10,session 9,1500000,378176,1619602,2001,1241426,session920010810,session 92001
92,2011-02-11,mooz-lum,1500000,362239,372239,2011,10000,moozlum20110211,mooz-lum2011
93,2007-09-05,i want someone to eat cheese with,1500000,194568,194568,2007,0,iwantsomeonetoeatcheesewith20070905,i want someone to eat cheese with2007
94,2011-08-19,amigo,1500000,184705,184705,2011,0,amigo20110819,amigo2011
95,2007-09-07,hatchet,1500000,175281,240396,2007,65115,hatchet20070907,hatchet2007
96,2008-10-31,my name is bruce,1500000,173066,173066,2008,0,mynameisbruce20081031,my name is bruce2008
97,2010-08-06,the disappearance of alice creed,1500000,166980,1605139,2010,1438159,thedisappearanceofalicecreed20100806,the disappearance of alice creed2010
99,2007-05-11,the salon,1500000,139084,139084,2007,0,thesalon20070511,the salon2007
100,2013-10-25,the square,1500000,124244,176262,2013,52018,thesquare20131025,the square2013
1,2002-03-22,stolen summer,1500000,119841,119841,2002,0,stolensummer20020322,stolen summer2002
2,2015-03-06,road hard,1500000,113169,113169,2015,0,roadhard20150306,road hard2015
3,2005-09-28,forty shades of blue,1500000,75828,172569,2005,96741,fortyshadesofblue20050928,forty shades of blue2005
4,2009-10-09,trucker,1500000,52429,52429,2009,0,trucker20091009,trucker2009
5,2009-05-29,pontypool,1500000,3865,31916,2009,28051,pontypool20090529,pontypool2009
6,2015-09-28,"me, you and five bucks",1500000,2105,2105,2015,0,meyouandfivebucks20150928,"me, you and five bucks2015"
7,2014-10-17,housebound,1500000,0,236863,2014,236863,housebound20141017,housebound2014
8,2018-07-20,teefa in trouble,1500000,0,98806,2018,98806,teefaintrouble20180720,teefa in trouble2018
9,2005-11-04,wal-mart: the high cost of low price,1500000,0,58692,2005,58692,walmartthehighcostoflowprice20051104,wal-mart: the high cost of low price2005
10,2014-04-17,closer to the moon,1500000,0,5396,2014,5396,closertothemoon20140417,closer to the moon2014
11,2006-03-17,fetching cody,1500000,0,0,2006,0,fetchingcody20060317,fetching cody2006
12,2011-06-03,the lion of judah,1500000,0,0,2011,0,thelionofjudah20110603,the lion of judah2011
13,2014-11-11,once upon a time in queens,1500000,0,0,2014,0,onceuponatimeinqueens20141111,once upon a time in queens2014
14,2015-02-13,girlhouse,1500000,0,0,2015,0,girlhouse20150213,girlhouse2015
15,2015-05-26,mutant world,1500000,0,0,2015,0,mutantworld20150526,mutant world2015
16,2015-11-20,#horror,1500000,0,0,2015,0,horror20151120,#horror2015
17,2015-09-08,checkmate,1500000,0,0,2015,0,checkmate20150908,checkmate2015
20,2018-11-30,werk ohne autor,1400000,1303747,4331152,2018,3027405,werkohneautor20181130,werk ohne autor2018
21,2015-11-20,mustang,1400000,845464,5552584,2015,4707120,mustang20151120,mustang2015
22,2005-04-29,the holy girl,1400000,304124,1261792,2005,957668,theholygirl20050429,the holy girl2005
23,2014-10-03,la chambre bleue,1400000,260441,1945420,2014,1684979,lachambrebleue20141003,la chambre bleue2014
24,2004-09-17,incident at loch ness,1400000,36830,56073,2004,19243,incidentatlochness20040917,incident at loch ness2004
25,2013-04-05,eddie: the sleepwalking cannibal,1400000,1632,1632,2013,0,eddiethesleepwalkingcannibal20130405,eddie: the sleepwalking cannibal2013
26,2010-05-01,my girlfriend's boyfriend,1400000,0,0,2010,0,mygirlfriendsboyfriend20100501,my girlfriend's boyfriend2010
27,2014-12-31,kurmanjan datka,1400000,0,0,2014,0,kurmanjandatka20141231,kurmanjan datka2014
28,2014-12-31,house at the end of the drive,1400000,0,0,2014,0,houseattheendofthedrive20141231,house at the end of the drive2014
35,2009-05-22,the girlfriend experience,1300000,695840,1005840,2009,310000,thegirlfriendexperience20090522,the girlfriend experience2009
36,2007-03-23,journey from the fall,1300000,635305,635305,2007,0,journeyfromthefall20070323,journey from the fall2007
37,2000-05-05,the basket,1300000,609042,609042,2000,0,thebasket20000505,the basket2000
38,2015-01-30,above and beyond,1300000,288751,288751,2015,0,aboveandbeyond20150130,above and beyond2015
40,2005-12-09,neal n' nikki,1300000,100358,329621,2005,229263,nealnnikki20051209,neal n' nikki2005
41,2003-12-19,the hebrew hammer,1300000,77755,90213,2003,12458,thehebrewhammer20031219,the hebrew hammer2003
42,2014-06-13,los insolitos peces gato,1300000,11278,54665,2014,43387,losinsolitospecesgato20140613,los insolitos peces gato2014
43,2006-04-07,simon,1300000,4055,1738663,2006,1734608,simon20060407,simon2006
44,2011-05-24,forget me not,1300000,0,13465,2011,13465,forgetmenot20110524,forget me not2011
45,2010-06-08,the 41-year-old virgin who knocked up sarah marshall and felt superbad about it,1300000,0,0,2010,0,the41yearoldvirginwhoknockedupsarahmarshallandfeltsuperbadaboutit20100608,the 41-year-old virgin who knocked up sarah marshall and felt superbad about it2010
46,2015-06-26,the algerian,1300000,0,0,2015,0,thealgerian20150626,the algerian2015
51,2014-10-17,dear white people,1250000,4404154,5403771,2014,999617,dearwhitepeople20141017,dear white people2014
52,2013-04-19,filly brown,1250000,2850357,2940411,2013,90054,fillybrown20130419,filly brown2013
54,2016-12-31,bodom,1250000,0,726460,2016,726460,bodom20161231,bodom2016
56,2015-01-13,da sweet blood of jesus,1250000,0,0,2015,0,dasweetbloodofjesus20150113,da sweet blood of jesus2015
57,2004-10-29,saw,1200000,55968727,103880027,2004,47911300,saw20041029,saw2004
59,2002-02-15,super troopers,1200000,18492362,23046142,2002,4553780,supertroopers20020215,super troopers2002
60,2002-02-22,monsoon wedding,1200000,13876974,27025600,2002,13148626,monsoonwedding20020222,monsoon wedding2002
61,2000-11-10,you can count on me,1200000,9180275,10827356,2000,1647081,youcancountonme20001110,you can count on me2000
66,2013-04-19,home run,1200000,2859955,2859955,2013,0,homerun20130419,home run2013
68,2000-07-07,but i'm a cheerleader,1200000,2205627,2509344,2000,303717,butimacheerleader20000707,but i'm a cheerleader2000
72,2012-04-13,blue like jazz,1200000,595018,595018,2012,0,bluelikejazz20120413,blue like jazz2012
73,2015-08-28,que horas ela volta?,1200000,376976,3249041,2015,2872065,quehoraselavolta20150828,que horas ela volta?2015
75,2003-03-21,down & out with the dolls,1200000,58936,58936,2003,0,downoutwiththedolls20030321,down & out with the dolls2003
76,2012-06-01,"pink ribbons, inc.",1200000,26608,26608,2012,0,pinkribbonsinc20120601,"pink ribbons, inc.2012"
77,2018-02-06,blood feast,1200000,8708,8708,2018,0,bloodfeast20180206,blood feast2018
78,2011-02-11,certifiably jonathan,1200000,7826,7826,2011,0,certifiablyjonathan20110211,certifiably jonathan2011
79,2015-09-18,la navaja de don juan,1200000,4254,4254,2015,0,lanavajadedonjuan20150918,la navaja de don juan2015
80,2008-12-31,extreme movie,1200000,0,81338,2008,81338,extrememovie20081231,extreme movie2008
82,2004-06-18,grand theft parsons,1200000,0,0,2004,0,grandtheftparsons20040618,grand theft parsons2004
83,2012-08-28,below zero,1200000,0,0,2012,0,belowzero20120828,below zero2012
84,2012-09-07,crowsnest,1200000,0,0,2012,0,crowsnest20120907,crowsnest2012
85,2012-09-14,airborne,1200000,0,0,2012,0,airborne20120914,airborne2012
86,2014-09-09,cotton comes to harlem,1200000,0,0,2014,0,cottoncomestoharlem20140909,cotton comes to harlem2014
87,2015-02-03,bleeding hearts,1200000,0,0,2015,0,bleedinghearts20150203,bleeding hearts2015
88,2013-12-31,the wicked within,1200000,0,0,2013,0,thewickedwithin20131231,the wicked within2013
89,2017-12-31,the islands,1200000,0,0,2017,0,theislands20171231,the islands2017
90,2014-03-21,godâs not dead,1150000,60755732,63777092,2014,3021360,godâsnotdead20140321,godâs not dead2014
91,2005-10-07,waiting...,1125000,16124543,18673274,2005,2548731,waiting20051007,waiting...2005
92,2006-05-12,dead man's shoes,1125000,6408,414736,2006,408328,deadmansshoes20060512,dead man's shoes2006
94,2005-12-25,wolf creek,1100000,16186348,29005064,2005,12818716,wolfcreek20051225,wolf creek2005
95,2005-02-11,ong-bak,1100000,4563167,24062965,2005,19499798,ongbak20050211,ong-bak2005
96,2012-03-23,serbuan maut,1100000,4105123,9297407,2012,5192284,serbuanmaut20120323,serbuan maut2012
99,2002-02-22,sex with strangers,1100000,247740,247740,2002,0,sexwithstrangers20020222,sex with strangers2002
100,2012-05-18,beyond the black rainbow,1100000,56491,56491,2012,0,beyondtheblackrainbow20120518,beyond the black rainbow2012
1,2003-05-14,dracula: pages from a virgin's diary,1100000,39659,81371,2003,41712,draculapagesfromavirginsdiary20030514,dracula: pages from a virgin's diary2003
2,2014-11-21,the sleepwalker,1100000,2636,2636,2014,0,thesleepwalker20141121,the sleepwalker2014
3,2017-03-07,departure,1100000,0,27561,2017,27561,departure20170307,departure2017
4,2009-04-07,faith like potatoes,1100000,0,0,2009,0,faithlikepotatoes20090407,faith like potatoes2009
5,2010-03-23,lake mungo,1100000,0,0,2010,0,lakemungo20100323,lake mungo2010
6,2015-04-07,silent running,1100000,0,0,2015,0,silentrunning20150407,silent running2015
7,2010-12-31,the dead undead,1100000,0,0,2010,0,thedeadundead20101231,the dead undead2010
8,2013-12-31,the vatican exorcisms,1100000,0,0,2013,0,thevaticanexorcisms20131231,the vatican exorcisms2013
9,2009-12-11,rocket singh: salesman of the year,1070000,164649,5348767,2009,5184118,rocketsinghsalesmanoftheyear20091211,rocket singh: salesman of the year2009
12,2012-01-06,the devil inside,1000000,53262945,101759490,2012,48496545,thedevilinside20120106,the devil inside2012
14,2015-04-17,unfriended,1000000,32789645,64364198,2015,31574553,unfriended20150417,unfriended2015
16,2006-05-24,an inconvenient truth,1000000,24146161,53365925,2006,29219764,aninconvenienttruth20060524,an inconvenient truth2006
17,2013-08-23,you're next,1000000,18494006,26887177,2013,8393171,yourenext20130823,you're next2013
18,2012-05-25,chernobyl diaries,1000000,18119640,42411721,2012,24292081,chernobyldiaries20120525,chernobyl diaries2012
22,2016-03-11,"hello, my name is doris",1000000,14444999,14662703,2016,217704,hellomynameisdoris20160311,"hello, my name is doris2016"
23,2005-09-16,cry wolf,1000000,10047674,15943081,2005,5895407,crywolf20050916,cry wolf2005
24,2000-08-18,godzilla 2000,1000000,10037390,10037390,2000,0,godzilla200020000818,godzilla 20002000
25,2010-12-29,blue valentine,1000000,9737892,16566240,2010,6828348,bluevalentine20101229,blue valentine2010
26,2006-01-20,transamerica,1000000,9015303,16553163,2006,7537860,transamerica20060120,transamerica2006
29,2018-07-20,unfriended: dark web,1000000,8866745,16434588,2018,7567843,unfriendeddarkweb20180720,unfriended: dark web2018
31,2015-09-25,the green inferno,1000000,7192291,12931420,2015,5739129,thegreeninferno20150925,the green inferno2015
32,2017-02-03,i am not your negro,1000000,7123919,9617402,2017,2493483,iamnotyournegro20170203,i am not your negro2017
33,2012-10-19,the sessions,1000000,6002451,11495204,2012,5492753,thesessions20121019,the sessions2012
34,2008-04-04,shine a light,1000000,5505267,16173879,2008,10668612,shinealight20080404,shine a light2008
35,2012-03-23,october baby,1000000,5355847,5391992,2012,36145,octoberbaby20120323,october baby2012
36,2014-09-12,the skeleton twins,1000000,5284309,5797192,2014,512883,theskeletontwins20140912,the skeleton twins2014
37,2013-06-14,20 feet from stardom,1000000,4946250,5892466,2013,946216,20feetfromstardom20130614,20 feet from stardom2013
38,2009-06-12,"food, inc.",1000000,4417674,4731944,2009,314270,foodinc20090612,"food, inc.2009"
39,2017-07-28,an inconvenient sequel,1000000,3496795,5839322,2017,2342527,aninconvenientsequel20170728,an inconvenient sequel2017
41,2014-06-06,obvious child,1000000,3122616,3324070,2014,201454,obviouschild20140606,obvious child2014
42,2011-10-21,martha marcy may marlene,1000000,2981038,5438911,2011,2457873,marthamarcymaymarlene20111021,martha marcy may marlene2011
43,2005-08-03,junebug,1000000,2678010,3553253,2005,875243,junebug20050803,junebug2005
44,2008-08-01,frozen river,1000000,2511476,6030129,2008,3518653,frozenriver20080801,frozen river2008
45,2001-11-21,sidewalks of new york,1000000,2402459,3575308,2001,1172849,sidewalksofnewyork20011121,sidewalks of new york2001
47,2000-09-29,the broken hearts club: a romantic comedy,1000000,1744858,2022442,2000,277584,thebrokenheartsclubaromanticcomedy20000929,the broken hearts club: a romantic comedy2000
48,2006-06-28,who killed the electric car?,1000000,1678874,1849392,2006,170518,whokilledtheelectriccar20060628,who killed the electric car?2006
49,2009-09-18,the secrets of jonathan sperry,1000000,1355079,1355079,2009,0,thesecretsofjonathansperry20090918,the secrets of jonathan sperry2009
51,2003-09-19,bubba ho-tep,1000000,1239183,1492895,2003,253712,bubbahotep20030919,bubba ho-tep2003
52,2001-12-07,no man's land,1000000,1067481,2684207,2001,1616726,nomansland20011207,no man's land2001
54,2017-10-06,visages villages,1000000,952432,4015686,2017,3063254,visagesvillages20171006,visages villages2017
55,2001-04-06,brigham city,1000000,852206,852206,2001,0,brighamcity20010406,brigham city2001
56,2017-08-18,patti cake$,1000000,800148,1471090,2017,670942,patticake20170818,patti cake$2017
57,2000-12-01,panic,1000000,779137,1425707,2000,646570,panic20001201,panic2000
58,2014-05-09,palo alto,1000000,767732,1156309,2014,388577,paloalto20140509,palo alto2014
59,2000-09-08,fiza,1000000,623791,1179462,2000,555671,fiza20000908,fiza2000
60,2010-02-03,ajami,1000000,621859,2721096,2010,2099237,ajami20100203,ajami2010
62,2011-07-29,the future,1000000,568662,1239174,2011,670512,thefuture20110729,the future2011
63,2003-02-14,all the real girls,1000000,549666,703020,2003,153354,alltherealgirls20030214,all the real girls2003
64,2014-10-24,23 blast,1000000,549185,549185,2014,0,23blast20141024,23 blast2014
66,2013-07-19,the act of killing,1000000,486919,1227316,2013,740397,theactofkilling20130719,the act of killing2013
67,2003-05-02,blue car,1000000,464126,475367,2003,11241,bluecar20030502,blue car2003
68,2007-10-19,wristcutters: a love story,1000000,446165,473769,2007,27604,wristcuttersalovestory20071019,wristcutters: a love story2007
69,2000-05-05,luminarias,1000000,428535,428535,2000,0,luminarias20000505,luminarias2000
70,2014-07-18,i origins,1000000,336472,852399,2014,515927,iorigins20140718,i origins2014
71,2014-11-28,antarctica: a year on ice,1000000,288757,288757,2014,0,antarcticaayearonice20141128,antarctica: a year on ice2014
72,2003-08-22,the battle of shaker heights,1000000,280351,839145,2003,558794,thebattleofshakerheights20030822,the battle of shaker heights2003
73,2008-01-18,taxi to the dark side,1000000,274661,304472,2008,29811,taxitothedarkside20080118,taxi to the dark side2008
74,2016-04-08,the invitation,1000000,231738,354836,2016,123098,theinvitation20160408,the invitation2016
75,2004-09-24,guiana 1838,1000000,227241,227241,2004,0,guiana183820040924,guiana 18382004
76,2002-12-30,love liza,1000000,213137,213137,2002,0,loveliza20021230,love liza2002
77,2006-07-07,once in a lifetime: the extraordinary story of the new york cosmos,1000000,144601,215559,2006,70958,onceinalifetimetheextraordinarystoryofthenewyorkcosmos20060707,once in a lifetime: the extraordinary story of the new york cosmos2006
78,2001-08-22,lisa picard is famous,1000000,113433,113433,2001,0,lisapicardisfamous20010822,lisa picard is famous2001
79,2015-07-31,beyond the brick: a lego brickumentary,1000000,101531,101531,2015,0,beyondthebrickalegobrickumentary20150731,beyond the brick: a lego brickumentary2015
80,2009-10-30,the house of the devil,1000000,101215,102812,2009,1597,thehouseofthedevil20091030,the house of the devil2009
81,2012-06-01,hardflip,1000000,96734,96734,2012,0,hardflip20120601,hardflip2012
82,2016-03-11,creative control,1000000,63014,63014,2016,0,creativecontrol20160311,creative control2016
83,2005-09-16,chocolate: deep dark secrets,1000000,49000,1549000,2005,1500000,chocolatedeepdarksecrets20050916,chocolate: deep dark secrets2005
84,2011-07-01,the perfect host,1000000,48764,51587,2011,2823,theperfecthost20110701,the perfect host2011
87,2001-08-31,speedway junky,1000000,17127,17127,2001,0,speedwayjunky20010831,speedway junky2001
88,2015-02-13,hits,1000000,15156,15156,2015,0,hits20150213,hits2015
89,2000-09-22,the specials,1000000,12996,12996,2000,0,thespecials20000922,the specials2000
90,2010-09-03,16 to life,1000000,11574,11574,2010,0,16tolife20100903,16 to life2010
91,2007-01-17,alone with her,1000000,10787,844377,2007,833590,alonewithher20070117,alone with her2007
92,2014-10-17,camp x-ray,1000000,9837,101053,2014,91216,campxray20141017,camp x-ray2014
93,2008-11-21,special,1000000,7202,26822,2008,19620,special20081121,special2008
94,2015-04-10,the sisterhood of night,1000000,6870,6870,2015,0,thesisterhoodofnight20150410,the sisterhood of night2015
96,2005-03-18,the helixâ¦loaded,1000000,3700,3700,2005,0,thehelixâloaded20050318,the helixâ¦loaded2005
97,2015-05-15,childless,1000000,1036,1036,2015,0,childless20150515,childless2015
98,2006-04-21,in her line of fire,1000000,884,884,2006,0,inherlineoffire20060421,in her line of fire2006
99,2002-12-13,the jimmy show,1000000,703,703,2002,0,thejimmyshow20021213,the jimmy show2002
100,2013-12-31,heli,1000000,0,552614,2013,552614,heli20131231,heli2013
1,2015-12-31,karachi se lahore,1000000,0,17721,2015,17721,karachiselahore20151231,karachi se lahore2015
2,2006-12-31,loving annabelle,1000000,0,5382,2006,5382,lovingannabelle20061231,loving annabelle2006
3,2015-12-11,american hero,1000000,0,26,2015,26,americanhero20151211,american hero2015
4,2009-12-01,frat party,1000000,0,0,2009,0,fratparty20091201,frat party2009
5,2006-09-15,jimmy and judy,1000000,0,0,2006,0,jimmyandjudy20060915,jimmy and judy2006
6,2003-10-24,the party's over,1000000,0,0,2003,0,thepartysover20031024,the party's over2003
7,2009-07-17,the poker house,1000000,0,0,2009,0,thepokerhouse20090717,the poker house2009
8,2005-09-23,proud,1000000,0,0,2005,0,proud20050923,proud2005
9,2008-12-31,steppin: the movie,1000000,0,0,2008,0,steppinthemovie20081231,steppin: the movie2008
10,2010-01-29,zombies of mass destruction,1000000,0,0,2010,0,zombiesofmassdestruction20100129,zombies of mass destruction2010
11,2012-03-20,snow white: a deadly summer,1000000,0,0,2012,0,snowwhiteadeadlysummer20120320,snow white: a deadly summer2012
12,2012-10-09,truth or die,1000000,0,0,2012,0,truthordie20121009,truth or die2012
13,2013-05-14,black rock,1000000,0,0,2013,0,blackrock20130514,black rock2013
14,2014-01-07,hidden away,1000000,0,0,2014,0,hiddenaway20140107,hidden away2014
15,2013-10-04,my last day without you,1000000,0,0,2013,0,mylastdaywithoutyou20131004,my last day without you2013
16,2013-10-08,zombie hunter,1000000,0,0,2013,0,zombiehunter20131008,zombie hunter2013
17,2014-12-31,doc holliday's revenge,1000000,0,0,2014,0,dochollidaysrevenge20141231,doc holliday's revenge2014
18,2014-06-24,a fine step,1000000,0,0,2014,0,afinestep20140624,a fine step2014
19,2015-02-10,fear clinic,1000000,0,0,2015,0,fearclinic20150210,fear clinic2015
20,2015-03-10,the pet,1000000,0,0,2015,0,thepet20150310,the pet2015
21,2014-12-31,bang bang baby,1000000,0,0,2014,0,bangbangbaby20141231,bang bang baby2014
22,2016-04-08,hush,1000000,0,0,2016,0,hush20160408,hush2016
23,2016-03-01,1982,1000000,0,0,2016,0,198220160301,19822016
24,2015-10-27,the horror network,1000000,0,0,2015,0,thehorrornetwork20151027,the horror network2015
25,2016-12-31,chemical cut,1000000,0,0,2016,0,chemicalcut20161231,chemical cut2016
26,2015-12-22,por amor en el caserio,1000000,0,0,2015,0,poramorenelcaserio20151222,por amor en el caserio2015
27,2007-06-01,and then came love,989000,8158,8158,2007,0,andthencamelove20070601,and then came love2007
28,2006-04-14,hard candy,950000,1024640,8267066,2006,7242426,hardcandy20060414,hard candy2006
29,2002-09-27,charly,950000,814666,814666,2002,0,charly20020927,charly2002
30,2014-01-10,banshee chapter,950000,0,78122,2014,78122,bansheechapter20140110,banshee chapter2014
31,2012-12-31,trance,950000,0,0,2012,0,trance20121231,trance2012
32,2014-08-12,jesse,950000,0,0,2014,0,jesse20140812,jesse2014
33,2015-03-03,ask me anything,950000,0,0,2015,0,askmeanything20150303,ask me anything2015
34,2012-04-13,l!fe happens,930000,30905,30905,2012,0,lfehappens20120413,l!fe happens2012
35,2017-05-12,lowriders,916000,6179955,6188421,2017,8466,lowriders20170512,lowriders2017
36,2014-11-21,food chains,913000,0,176,2014,176,foodchains20141121,food chains2014
38,2013-07-12,fruitvale station,900000,16098998,17549645,2013,1450647,fruitvalestation20130712,fruitvale station2013
39,2016-04-01,meet the blacks,900000,9097072,9097072,2016,0,meettheblacks20160401,meet the blacks2016
40,2008-01-25,"4 luni, 3 saptamani si 2 zile",900000,1196321,11993156,2008,10796835,4luni3saptamanisi2zile20080125,"4 luni, 3 saptamani si 2 zile2008"
41,2011-08-26,circumstance,900000,454121,958978,2011,504857,circumstance20110826,circumstance2011
42,2006-08-25,the quiet,900000,381420,381420,2006,0,thequiet20060825,the quiet2006
43,2012-04-27,the giant mechanical man,900000,7396,7396,2012,0,thegiantmechanicalman20120427,the giant mechanical man2012
44,2013-04-05,the brass teapot,900000,6997,413733,2013,406736,thebrassteapot20130405,the brass teapot2013
45,2014-12-31,40 weeks,900000,0,0,2014,0,40weeks20141231,40 weeks2014
46,2015-05-05,le bonheur d'elza,900000,0,0,2015,0,lebonheurdelza20150505,le bonheur d'elza2015
48,2012-08-31,"for a good time, call",850000,1251749,1386088,2012,134339,foragoodtimecall20120831,"for a good time, call2012"
49,2004-01-30,latter days,850000,833118,865708,2004,32590,latterdays20040130,latter days2004
50,2008-03-21,the hammer,850000,442638,442638,2008,0,thehammer20080321,the hammer2008
51,2015-08-28,windsor drive,850000,3256,3256,2015,0,windsordrive20150828,windsor drive2015
52,2012-12-31,snitch,850000,0,0,2012,0,snitch20121231,snitch2012
53,2008-12-31,harrison montgomery,850000,0,0,2008,0,harrisonmontgomery20081231,harrison montgomery2008
54,2012-08-03,celeste and jesse forever,840000,3103407,3787689,2012,684282,celesteandjesseforever20120803,celeste and jesse forever2012
55,2002-10-25,time changer,825000,1500711,1500711,2002,0,timechanger20021025,time changer2002
56,2009-08-11,london to brighton,825000,0,610776,2009,610776,londontobrighton20090811,london to brighton2009
57,2009-12-31,crying with laughter,820000,0,16909,2009,16909,cryingwithlaughter20091231,crying with laughter2009
59,2011-12-30,jodaeiye nader az simin,800000,7098492,24426169,2011,17327677,jodaeiyenaderazsimin20111230,jodaeiye nader az simin2011
61,2003-03-28,raising victor vargas,800000,2073984,2900578,2003,826594,raisingvictorvargas20030328,raising victor vargas2003
63,2002-08-09,pandora's box,800000,881950,881950,2002,0,pandorasbox20020809,pandora's box2002
64,2007-07-18,cama adentro,800000,200433,200433,2007,0,camaadentro20070718,cama adentro2007
65,2000-03-10,deterrence,800000,144583,371647,2000,227064,deterrence20000310,deterrence2000
66,2004-05-07,the mudge boy,800000,62544,62544,2004,0,themudgeboy20040507,the mudge boy2004
67,2003-04-11,the young unknowns,800000,58163,58163,2003,0,theyoungunknowns20030411,the young unknowns2003
68,2009-06-19,dã¸d snã¸,800000,46742,2194020,2009,2147278,dãdsnã20090619,dã¸d snã¸2009
69,2014-09-19,not cool,800000,35688,35688,2014,0,notcool20140919,not cool2014
70,2012-02-03,kill list,800000,29063,462206,2012,433143,killlist20120203,kill list2012
71,2015-01-09,vessel,800000,0,0,2015,0,vessel20150109,vessel2015
72,2004-08-06,saints and soldiers,780000,1310470,1310470,2004,0,saintsandsoldiers20040806,saints and soldiers2004
74,2006-09-08,iraq for sale: the war profiteers,775000,0,0,2006,0,iraqforsalethewarprofiteers20060908,iraq for sale: the war profiteers2006
75,2011-09-09,kevin hart: laugh at my pain,750000,7706436,7712436,2011,6000,kevinhartlaughatmypain20110909,kevin hart: laugh at my pain2011
76,2007-04-13,aqua teen hunger force colon movie film for theaters,750000,5520368,5520368,2007,0,aquateenhungerforcecolonmoviefilmfortheaters20070413,aqua teen hunger force colon movie film for theaters2007
77,2012-06-08,safety not guaranteed,750000,4010957,4422318,2012,411361,safetynotguaranteed20120608,safety not guaranteed2012
78,2012-02-03,the innkeepers,750000,78396,1011535,2012,933139,theinnkeepers20120203,the innkeepers2012
79,2014-08-29,il conformista,750000,59656,89609,2014,29953,ilconformista20140829,il conformista2014
80,2002-11-15,interview with the assassin,750000,47329,47329,2002,0,interviewwiththeassassin20021115,interview with the assassin2002
81,2005-07-01,undead,750000,41196,229250,2005,188054,undead20050701,undead2005
82,2009-01-23,donkey punch,750000,19367,814801,2009,795434,donkeypunch20090123,donkey punch2009
83,2013-10-11,all the boys love mandy lane,750000,0,1960521,2013,1960521,alltheboyslovemandylane20131011,all the boys love mandy lane2013
84,2014-12-31,destiny,750000,0,450,2014,450,destiny20141231,destiny2014
85,2009-04-07,bled,750000,0,0,2009,0,bled20090407,bled2009
86,2016-01-05,adulterers,750000,0,0,2016,0,adulterers20160105,adulterers2016
90,2005-06-24,rize,700000,3278611,4857731,2005,1579120,rize20050624,rize2005
91,2006-08-11,half nelson,700000,2697938,4911725,2006,2213787,halfnelson20060811,half nelson2006
92,2001-09-07,l.i.e.,700000,1140965,1140965,2001,0,lie20010907,l.i.e.2001
93,2017-08-04,columbus,700000,1017107,1110511,2017,93404,columbus20170804,columbus2017
95,2010-01-26,b-girl,700000,0,1160,2010,1160,bgirl20100126,b-girl2010
96,2015-03-13,walter,700000,0,0,2015,0,walter20150313,walter2015
100,2013-10-11,escape from tomorrow,650000,171962,171962,2013,0,escapefromtomorrow20131011,escape from tomorrow2013
1,2018-12-14,that way madness lies,650000,1447,1447,2018,0,thatwaymadnesslies20181214,that way madness lies2018
2,2012-12-31,after,650000,0,0,2012,0,after20121231,after2012
3,2014-12-31,the hadza: last of the first,650000,0,0,2014,0,thehadzalastofthefirst20141231,the hadza: last of the first2014
4,2009-12-31,starsuckers,640000,0,14812,2009,14812,starsuckers20091231,starsuckers2009
5,2013-12-31,treachery,625000,0,0,2013,0,treachery20131231,treachery2013
11,2000-10-31,mercy streets,600000,173599,173599,2000,0,mercystreets20001031,mercy streets2000
12,2014-05-02,water & power,600000,42557,42557,2014,0,waterpower20140502,water & power2014
13,2007-10-19,arnolds park,600000,23616,23616,2007,0,arnoldspark20071019,arnolds park2007
15,2015-05-22,drunk wedding,600000,3301,3301,2015,0,drunkwedding20150522,drunk wedding2015
16,2016-03-04,they will have to kill us first,600000,0,7943,2016,7943,theywillhavetokillusfirst20160304,they will have to kill us first2016
17,2002-08-23,crop circles: quest for truth,600000,0,0,2002,0,cropcirclesquestfortruth20020823,crop circles: quest for truth2002
18,2014-08-08,the maid's room,600000,0,0,2014,0,themaidsroom20140808,the maid's room2014
19,2014-12-31,light from the darkroom,600000,0,0,2014,0,lightfromthedarkroom20141231,light from the darkroom2014
20,2015-02-24,irreplaceable,600000,0,0,2015,0,irreplaceable20150224,irreplaceable2015
22,2011-07-29,the harvest/la cosecha,560000,3709,3709,2011,0,theharvestlacosecha20110729,the harvest/la cosecha2011
23,2015-12-31,julija in alfa romeo,560000,0,8462,2015,8462,julijainalfaromeo20151231,julija in alfa romeo2015
27,2014-09-12,faith connections,550000,9111,9111,2014,0,faithconnections20140912,faith connections2014
28,2012-03-06,high road,546173,0,0,2012,0,highroad20120306,high road2012
29,2008-09-26,fireproof,500000,33456317,33473297,2008,16980,fireproof20080926,fireproof2008
31,2004-08-06,open water,500000,30500882,55518641,2004,25017759,openwater20040806,open water2004
33,2005-05-13,mad hot ballroom,500000,8117961,9387581,2005,1269620,madhotballroom20050513,mad hot ballroom2005
34,2003-10-03,the station agent,500000,5801558,9470209,2003,3668651,thestationagent20031003,the station agent2003
35,2010-01-22,to save a life,500000,3777210,3824868,2010,47658,tosavealife20100122,to save a life2010
36,2006-06-16,wordplay,500000,3121270,3177636,2006,56366,wordplay20060616,wordplay2006
38,2002-02-01,the singles ward,500000,1250798,1250798,2002,0,thesinglesward20020201,the singles ward2002
39,2011-07-08,sholem aleichem: laughing in the darkness,500000,1131261,1131261,2011,0,sholemaleichemlaughinginthedarkness20110708,sholem aleichem: laughing in the darkness2011
40,2004-01-30,osama,500000,1127331,1971479,2004,844148,osama20040130,osama2004
41,2000-06-09,groove,500000,1115313,1167524,2000,52211,groove20000609,groove2000
42,2003-01-31,the r.m.,500000,1111615,1111615,2003,0,therm20030131,the r.m.2003
44,2004-08-20,mean creek,500000,603951,1348750,2004,744799,meancreek20040820,mean creek2004
45,2013-08-23,drinking buddies,500000,343706,407100,2013,63394,drinkingbuddies20130823,drinking buddies2013
47,2002-07-12,never again,500000,307631,308793,2002,1162,neveragain20020712,never again2002
49,2003-08-29,civil brand,500000,254293,254293,2003,0,civilbrand20030829,civil brand2003
50,2010-10-29,monsters,500000,237301,5639730,2010,5402429,monsters20101029,monsters2010
51,2006-03-24,lonesome jim,500000,154187,602789,2006,448602,lonesomejim20060324,lonesome jim2006
52,2013-04-17,deceptive practice: the mysteries and mentors of ricky jay,500000,152449,152449,2013,0,deceptivepracticethemysteriesandmentorsofrickyjay20130417,deceptive practice: the mysteries and mentors of ricky jay2013
53,2012-09-28,the other dream team,500000,134109,314444,2012,180335,theotherdreamteam20120928,the other dream team2012
54,2015-12-11,o menino e o mundo,500000,129479,280967,2015,151488,omeninoeomundo20151211,o menino e o mundo2015
55,2011-04-01,rubber,500000,100370,680914,2011,580544,rubber20110401,rubber2011
57,2007-10-05,finishing the game,500000,52850,53201,2007,351,finishingthegame20071005,finishing the game2007
58,2008-04-18,kiss the bride,500000,32033,32033,2008,0,kissthebride20080418,kiss the bride2008
59,2003-07-11,the journey,500000,19800,19800,2003,0,thejourney20030711,the journey2003
60,2009-04-23,home,500000,15433,44793168,2009,44777735,home20090423,home2009
61,2003-01-10,the slaughter rule,500000,13134,13134,2003,0,theslaughterrule20030110,the slaughter rule2003
62,2010-05-14,the living wake,500000,12232,12232,2010,0,thelivingwake20100514,the living wake2010
63,2009-02-27,scott walker: 30 century man,500000,6840,77121,2009,70281,scottwalker30centuryman20090227,scott walker: 30 century man2009
64,2005-10-21,the californians,500000,4134,4134,2005,0,thecalifornians20051021,the californians2005
65,2014-09-10,born to fly: elizabeth streb vs. gravity,500000,1822,1822,2014,0,borntoflyelizabethstrebvsgravity20140910,born to fly: elizabeth streb vs. gravity2014
66,2013-06-28,detention of the dead,500000,1778,1778,2013,0,detentionofthedead20130628,detention of the dead2013
67,2018-05-11,higher power,500000,528,528,2018,0,higherpower20180511,higher power2018
68,2006-12-31,feng kuang de shi tou,500000,0,3000000,2006,3000000,fengkuangdeshitou20061231,feng kuang de shi tou2006
69,2013-01-08,now is good,500000,0,2141436,2013,2141436,nowisgood20130108,now is good2013
70,2006-12-31,griffin & phoenix,500000,0,1355967,2006,1355967,griffinphoenix20061231,griffin & phoenix2006
71,2001-11-02,everything put together,500000,0,7890,2001,7890,everythingputtogether20011102,everything put together2001
72,2010-12-31,drones,500000,0,0,2010,0,drones20101231,drones2010
73,2012-04-03,enter nowhere,500000,0,0,2012,0,enternowhere20120403,enter nowhere2012
74,2012-07-17,girls gone dead,500000,0,0,2012,0,girlsgonedead20120717,girls gone dead2012
75,2005-12-31,insomnia manica,500000,0,0,2005,0,insomniamanica20051231,insomnia manica2005
76,2014-12-31,america is still the place,500000,0,0,2014,0,americaisstilltheplace20141231,america is still the place2014
77,2015-07-24,the outrageous sophie tucker,500000,0,0,2015,0,theoutrageoussophietucker20150724,the outrageous sophie tucker2015
78,2015-03-10,subconscious,500000,0,0,2015,0,subconscious20150310,subconscious2015
79,2015-04-14,roadside,500000,0,0,2015,0,roadside20150414,roadside2015
80,2014-12-31,diamond ruff,500000,0,0,2014,0,diamondruff20141231,diamond ruff2014
81,2015-02-10,love in the time of monsters,500000,0,0,2015,0,loveinthetimeofmonsters20150210,love in the time of monsters2015
82,2012-12-31,el rey de najayo,500000,0,0,2012,0,elreydenajayo20121231,el rey de najayo2012
83,2015-12-31,fight to the finish,500000,0,0,2015,0,fighttothefinish20151231,fight to the finish2015
84,2013-12-31,bucky and the squirrels,500000,0,0,2013,0,buckyandthesquirrels20131231,bucky and the squirrels2013
86,2015-06-23,crossroads,500000,0,0,2015,0,crossroads20150623,crossroads2015
87,2015-08-11,alleluia! the devil's carnival,500000,0,0,2015,0,alleluiathedevilscarnival20150811,alleluia! the devil's carnival2015
88,2015-12-01,brooklyn bizarre,500000,0,0,2015,0,brooklynbizarre20151201,brooklyn bizarre2015
89,2014-12-31,the sound and the shadow,500000,0,0,2014,0,thesoundandtheshadow20141231,the sound and the shadow2014
90,2015-12-31,rodeo girl,500000,0,0,2015,0,rodeogirl20151231,rodeo girl2015
91,2015-11-10,the little ponderosa zoo,500000,0,0,2015,0,thelittleponderosazoo20151110,the little ponderosa zoo2015
93,2009-09-25,paranormal activity,450000,107918810,194183034,2009,86264224,paranormalactivity20090925,paranormal activity2009
95,2006-03-31,brick,450000,2075743,4243996,2006,2168253,brick20060331,brick2006
97,2006-08-11,conversations with other women,450000,379418,1297745,2006,918327,conversationswithotherwomen20060811,conversations with other women2006
98,2015-11-20,siakh lokhamim: ha'slilim ha'gnouzim,450000,41260,42503,2015,1243,siakhlokhamimhaslilimhagnouzim20151120,siakh lokhamim: ha'slilim ha'gnouzim2015
99,2008-05-09,poultrygeist: night of the chicken dead,450000,13804,22623,2008,8819,poultrygeistnightofthechickendead20080509,poultrygeist: night of the chicken dead2008
100,2014-07-11,as it is in heaven,450000,13486,13486,2014,0,asitisinheaven20140711,as it is in heaven2014
1,2014-07-01,mutual friends,450000,0,0,2014,0,mutualfriends20140701,mutual friends2014
2,2014-12-31,rise of the entrepreneur - the search for a better way,450000,0,0,2014,0,riseoftheentrepreneurthesearchforabetterway20141231,rise of the entrepreneur - the search for a better way2014
5,2006-04-28,moartea domnului lazarescu,425000,80301,581304,2006,501003,moarteadomnuluilazarescu20060428,moartea domnului lazarescu2006
6,2005-01-21,gory gory hallelujah,425000,12604,12604,2005,0,gorygoryhallelujah20050121,gory gory hallelujah2005
7,2014-04-25,blue ruin,420000,258384,437002,2014,178618,blueruin20140425,blue ruin2014
8,2004-06-11,napoleon dynamite,400000,44540956,46122713,2004,1581757,napoleondynamite20040611,napoleon dynamite2004
10,2006-08-02,quinceanera,400000,1692693,2797199,2006,1104506,quinceanera20060802,quinceanera2006
11,2002-04-26,dogtown and z-boys,400000,1293295,1600566,2002,307271,dogtownandzboys20020426,dogtown and z-boys2002
12,2008-10-24,heroes,400000,655538,655538,2008,0,heroes20081024,heroes2008
13,2004-10-06,tarnation,400000,592014,1162014,2004,570000,tarnation20041006,tarnation2004
14,2010-10-15,i want your money,400000,433588,433588,2010,0,iwantyourmoney20101015,i want your money2010
17,2001-07-27,jackpot,400000,44452,44452,2001,0,jackpot20010727,jackpot2001
18,2004-12-10,fabled,400000,31425,31425,2004,0,fabled20041210,fabled2004
19,2005-10-13,the dark hours,400000,423,423,2005,0,thedarkhours20051013,the dark hours2005
20,2015-03-31,viskningar och rop,400000,0,9071,2015,9071,viskningarochrop20150331,viskningar och rop2015
22,2005-11-04,show me,400000,0,0,2005,0,showme20051104,show me2005
23,2014-12-31,pancakes,400000,0,0,2014,0,pancakes20141231,pancakes2014
30,2005-07-08,murderball,350000,1531154,1772979,2005,241825,murderball20050708,murderball2005
31,2010-09-01,my dog tulip,350000,246574,310891,2010,64317,mydogtulip20100901,my dog tulip2010
32,2006-10-18,51 birch street,350000,84689,84689,2006,0,51birchstreet20061018,51 birch street2006
33,2002-11-15,revolution#9,350000,9118,9118,2002,0,revolution920021115,revolution#92002
34,2009-04-10,royal kill,350000,0,0,2009,0,royalkill20090410,royal kill2009
35,2015-10-20,rotor dr1,350000,0,0,2015,0,rotordr120151020,rotor dr12015
39,2010-06-25,kynodontas,323000,110248,1373407,2010,1263159,kynodontas20100625,kynodontas2010
41,2003-11-14,tupac resurrection,300000,7718961,7808524,2003,89563,tupacresurrection20031114,tupac resurrection2003
42,2000-03-10,god's army,300000,2637726,2652515,2000,14789,godsarmy20000310,god's army2000
43,2003-10-17,pieces of april,300000,2528664,3571253,2003,1042589,piecesofapril20031017,pieces of april2003
45,2008-12-10,wendy and lucy,300000,865695,1416046,2008,550351,wendyandlucy20081210,wendy and lucy2008
47,2006-08-25,old joy,300000,255923,399908,2006,143985,oldjoy20060825,old joy2006
48,2005-07-15,first morning,300000,87264,87264,2005,0,firstmorning20050715,first morning2005
49,2007-06-15,pierrot le fou,300000,70807,71380,2007,573,pierrotlefou20070615,pierrot le fou2007
51,2011-03-11,3 backyards,300000,39475,39475,2011,0,3backyards20110311,3 backyards2011
52,2006-04-12,sisters in law,300000,33312,33312,2006,0,sistersinlaw20060412,sisters in law2006
53,2012-11-09,nothing but a man,300000,17241,17241,2012,0,nothingbutaman20121109,nothing but a man2012
54,2002-07-19,ayurveda: art of being,300000,16892,2066892,2002,2050000,ayurvedaartofbeing20020719,ayurveda: art of being2002
56,2005-05-06,fighting tommy riley,300000,10514,10514,2005,0,fightingtommyriley20050506,fighting tommy riley2005
57,2014-03-28,locker 13,300000,3496,3496,2014,0,locker1320140328,locker 132014
58,2015-10-23,the looking glass,300000,1711,1711,2015,0,thelookingglass20151023,the looking glass2015
59,2014-10-31,all you need is love,300000,0,3565259,2014,3565259,allyouneedislove20141031,all you need is love2014
61,2012-07-03,some guy who kills people,300000,0,0,2012,0,someguywhokillspeople20120703,some guy who kills people2012
62,2013-08-07,midnight cabaret,300000,0,0,2013,0,midnightcabaret20130807,midnight cabaret2013
63,2015-03-10,teeth and blood,300000,0,0,2015,0,teethandblood20150310,teeth and blood2015
64,2015-12-31,walking to paris,300000,0,0,2015,0,walkingtoparis20151231,walking to paris2015
65,2010-12-31,anderson's cross,300000,0,0,2010,0,andersonscross20101231,anderson's cross2010
66,2015-12-08,amidst the devil's wings,300000,0,0,2015,0,amidstthedevilswings20151208,amidst the devil's wings2015
67,2010-12-31,death calls,290000,0,0,2010,0,deathcalls20101231,death calls2010
68,2012-08-17,compliance,270000,319285,830700,2012,511415,compliance20120817,compliance2012
71,2002-06-28,lovely and amazing,250000,4210379,4613482,2002,403103,lovelyandamazing20020628,lovely and amazing2002
72,2017-04-28,sleight,250000,3930990,3934450,2017,3460,sleight20170428,sleight2017
73,2003-04-11,better luck tomorrow,250000,3802390,3809226,2003,6836,betterlucktomorrow20030411,better luck tomorrow2003
74,2011-10-28,like crazy,250000,3395391,3728400,2011,333009,likecrazy20111028,like crazy2011
76,2000-07-14,chuck&buck,250000,1055671,1157672,2000,102001,chuckbuck20000714,chuck&buck2000
77,2001-03-16,american desi,250000,902835,1366235,2001,463400,americandesi20010316,american desi2001
81,2005-07-22,november,250000,191862,191862,2005,0,november20050722,november2005
83,2008-03-28,happy valley,250000,67665,67665,2008,0,happyvalley20080328,happy valley2008
84,2013-08-02,the canyons,250000,59671,62375,2013,2704,thecanyons20130802,the canyons2013
85,2006-06-28,the motel,250000,51540,51540,2006,0,themotel20060628,the motel2006
86,2005-07-15,on the outs,250000,49772,237816,2005,188044,ontheouts20050715,on the outs2005
87,2007-12-14,shotgun stories,250000,46026,284174,2007,238148,shotgunstories20071214,shotgun stories2007
88,2014-08-15,nightlights,250000,21147,21147,2014,0,nightlights20140815,nightlights2014
89,2014-06-06,test,250000,18823,18823,2014,0,test20140606,test2014
91,2015-03-24,along the roadside,250000,0,3234,2015,3234,alongtheroadside20150324,along the roadside2015
92,2008-10-21,sunday school musical,250000,0,0,2008,0,sundayschoolmusical20081021,sunday school musical2008
93,2010-10-05,rust,250000,0,0,2010,0,rust20101005,rust2010
94,2010-12-31,the christmas bunny,250000,0,0,2010,0,thechristmasbunny20101231,the christmas bunny2010
95,2009-11-10,ink,250000,0,0,2009,0,ink20091110,ink2009
96,2012-12-18,the frozen,250000,0,0,2012,0,thefrozen20121218,the frozen2012
97,2014-04-11,jesus people,250000,0,0,2014,0,jesuspeople20140411,jesus people2014
98,2010-12-31,butterfly,250000,0,0,2010,0,butterfly20101231,butterfly2010
99,2015-02-03,undivided,250000,0,0,2015,0,undivided20150203,undivided2015
100,2014-12-31,horse camp,250000,0,0,2014,0,horsecamp20141231,horse camp2014
1,2015-02-24,give me shelter,250000,0,0,2015,0,givemeshelter20150224,give me shelter2015
2,2011-12-31,rock the house,250000,0,0,2011,0,rockthehouse20111231,rock the house2011
3,2015-12-31,shooting the warwicks,250000,0,0,2015,0,shootingthewarwicks20151231,shooting the warwicks2015
4,2015-08-18,the love letter,250000,0,0,2015,0,theloveletter20150818,the love letter2015
5,2015-10-09,western religion,250000,0,0,2015,0,westernreligion20151009,western religion2015
6,2015-01-01,4/11,250000,0,0,2015,0,41120150101,4/112015
8,2008-10-31,little big top,240000,7484,7484,2008,0,littlebigtop20081031,little big top2008
9,2009-10-09,bronson,230000,104979,2703762,2009,2598783,bronson20091009,bronson2009
10,2012-07-20,burn,225000,1109276,1109276,2012,0,burn20120720,burn2012
11,2000-09-15,urbania,225000,1032075,1032075,2000,0,urbania20000915,urbania2000
18,2011-02-25,the grace card,200000,2430735,2430735,2011,0,thegracecard20110225,the grace card2011
20,2000-02-11,trois,200000,1161843,1161843,2000,0,trois20000211,trois2000
21,2015-06-19,the overnight,200000,1109808,1165996,2015,56188,theovernight20150619,the overnight2015
22,2004-10-22,short cut to nirvana: kumbh mela,200000,381225,439651,2004,58426,shortcuttonirvanakumbhmela20041022,short cut to nirvana: kumbh mela2004
23,2012-10-12,middle of nowhere,200000,236806,236806,2012,0,middleofnowhere20121012,middle of nowhere2012
24,2008-10-10,call+response,200000,212989,212989,2008,0,callresponse20081010,call+response2008
25,2002-05-10,the business of fancy dancing,200000,174682,174682,2002,0,thebusinessoffancydancing20020510,the business of fancy dancing2002
26,2002-05-10,hybrid,200000,162605,162605,2002,0,hybrid20020510,hybrid2002
27,2008-06-13,baghead,200000,140016,140016,2008,0,baghead20080613,baghead2008
28,2004-09-10,malevolence,200000,126021,346106,2004,220085,malevolence20040910,malevolence2004
29,2005-09-09,side effects,200000,44701,44701,2005,0,sideeffects20050909,side effects2005
30,2008-10-10,good dick,200000,28835,52443,2008,23608,gooddick20081010,good dick2008
31,2006-07-21,the case of the grinning cat,200000,7033,7033,2006,0,thecaseofthegrinningcat20060721,the case of the grinning cat2006
32,2005-01-07,solitude,200000,6260,6260,2005,0,solitude20050107,solitude2005
33,2014-03-14,the word,200000,3648,3648,2014,0,theword20140314,the word2014
34,2007-06-15,the trials of darryl hunt,200000,1217,1217,2007,0,thetrialsofdarrylhunt20070615,the trials of darryl hunt2007
35,2007-10-19,the man from earth,200000,0,0,2007,0,themanfromearth20071019,the man from earth2007
36,2004-12-31,samantha: an american girl holiday,200000,0,0,2004,0,samanthaanamericangirlholiday20041231,samantha: an american girl holiday2004
37,2008-01-17,yesterday was a lie,200000,0,0,2008,0,yesterdaywasalie20080117,yesterday was a lie2008
38,2014-09-12,archaeology of a woman,200000,0,0,2014,0,archaeologyofawoman20140912,archaeology of a woman2014
39,2014-08-26,sanctuary; quite a conundrum,200000,0,0,2014,0,sanctuaryquiteaconundrum20140826,sanctuary; quite a conundrum2014
40,2015-09-29,theresa is a mother,200000,0,0,2015,0,theresaisamother20150929,theresa is a mother2015
41,2015-11-10,perfect cowboy,200000,0,0,2015,0,perfectcowboy20151110,perfect cowboy2015
42,2014-12-31,h.,200000,0,0,2014,0,h20141231,h.2014
43,2011-09-23,weekend,190000,484592,1577585,2011,1092993,weekend20110923,weekend2011
45,2015-02-27,butterfly girl,180000,17503,17503,2015,0,butterflygirl20150227,butterfly girl2015
46,2017-06-16,arrowhead,180000,0,0,2017,0,arrowhead20170616,arrowhead2017
48,2011-07-22,another earth,175000,1321194,2102779,2011,781585,anotherearth20110722,another earth2011
49,2013-08-23,sparrows dance,175000,2602,2602,2013,0,sparrowsdance20130823,sparrows dance2013
50,2015-09-04,heroes of dirt,175000,0,0,2015,0,heroesofdirt20150904,heroes of dirt2015
51,2016-06-03,the fits,170000,166425,169242,2016,2817,thefits20160603,the fits2016
53,2015-12-31,lumea e a mea,168000,0,29678,2015,29678,lumeaeamea20151231,lumea e a mea2015
54,2009-09-11,the horse boy,160000,156612,156612,2009,0,thehorseboy20090911,the horse boy2009
55,2002-03-01,the calling,160000,32092,32092,2002,0,thecalling20020301,the calling2002
57,2007-05-16,once,150000,9445857,23323631,2007,13877774,once20070516,once2007
58,2002-07-19,tadpole,150000,2891288,3270128,2002,378840,tadpole20020719,tadpole2002
59,2000-06-23,the woman chaser,150000,110719,110719,2000,0,thewomanchaser20000623,the woman chaser2000
60,2015-04-17,antarctic edge: 70âº south,150000,7193,7193,2015,0,antarcticedge70âºsouth20150417,antarctic edge: 70âº south2015
61,2015-08-21,top spin,150000,5858,5858,2015,0,topspin20150821,top spin2015
62,2013-12-31,speak no evil,150000,0,32927,2013,32927,speaknoevil20131231,speak no evil2013
63,2009-10-06,a charlie brown christmas,150000,0,0,2009,0,acharliebrownchristmas20091006,a charlie brown christmas2009
64,2013-05-03,aroused,150000,0,0,2013,0,aroused20130503,aroused2013
65,2015-12-31,escaping the holocost,150000,0,0,2015,0,escapingtheholocost20151231,escaping the holocost2015
68,2012-04-27,sound of my voice,135000,408015,429448,2012,21433,soundofmyvoice20120427,sound of my voice2012
70,2014-07-18,an american in hollywood,125000,0,0,2014,0,anamericaninhollywood20140718,an american in hollywood2014
71,2015-08-11,the brain that sings,125000,0,0,2015,0,thebrainthatsings20150811,the brain that sings2015
72,2015-12-31,romantic schemer,125000,0,0,2015,0,romanticschemer20151231,romantic schemer2015
73,2012-06-15,your sister's sister,120000,1597486,3090593,2012,1493107,yoursisterssister20120615,your sister's sister2012
74,2006-06-30,the blood of my brother: a story of death in iraq,120000,0,0,2006,0,thebloodofmybrotherastoryofdeathiniraq20060630,the blood of my brother: a story of death in iraq2006
75,2007-12-31,a dog's breakfast,120000,0,0,2007,0,adogsbreakfast20071231,a dog's breakfast2007
76,2016-05-24,une femme mariã©e,120000,0,0,2016,0,unefemmemariãe20160524,une femme mariã©e2016
79,2003-10-03,the work and the story,103000,16137,16137,2003,0,theworkandthestory20031003,the work and the story2003
80,2015-07-10,the gallows,100000,22764410,41656474,2015,18892064,thegallows20150710,the gallows2015
81,2006-09-29,facing the giants,100000,10178331,10243159,2006,64828,facingthegiants20060929,facing the giants2006
86,2017-07-07,a ghost story,100000,1594798,2769782,2017,1174984,aghoststory20170707,a ghost story2017
88,2004-02-06,the lost skeleton of cadavra,100000,110536,110536,2004,0,thelostskeletonofcadavra20040206,the lost skeleton of cadavra2004
89,2014-03-21,cheap thrills,100000,59424,59424,2014,0,cheapthrills20140321,cheap thrills2014
90,2014-06-19,the past is a grotesque animal,100000,20056,20056,2014,0,thepastisagrotesqueanimal20140619,the past is a grotesque animal2014
91,2001-11-09,keeping it real: the adventures of greg walloch,100000,1358,1358,2001,0,keepingitrealtheadventuresofgregwalloch20011109,keeping it real: the adventures of greg walloch2001
92,2012-05-18,indie game: the movie,100000,0,0,2012,0,indiegamethemovie20120518,indie game: the movie2012
93,2014-12-31,"dude, where's my dog",100000,0,0,2014,0,dudewheresmydog20141231,"dude, where's my dog2014"
94,2014-06-10,echo dr.,100000,0,0,2014,0,echodr20140610,echo dr.2014
95,2015-03-17,closure,100000,0,0,2015,0,closure20150317,closure2015
96,2015-12-31,lunchtime heroes,100000,0,0,2015,0,lunchtimeheroes20151231,lunchtime heroes2015
97,2015-03-25,open secret,100000,0,0,2015,0,opensecret20150325,open secret2015
98,2015-11-10,the night visitor,100000,0,0,2015,0,thenightvisitor20151110,the night visitor2015
99,2015-07-07,tiger orange,100000,0,0,2015,0,tigerorange20150707,tiger orange2015
1,2008-05-30,the foot fist way,79000,234286,234286,2008,0,thefootfistway20080530,the foot fist way2008
2,2015-07-17,dawn of the crescent moon,75000,8799,8799,2015,0,dawnofthecrescentmoon20150717,dawn of the crescent moon2015
3,2015-09-29,queen crab,75000,0,0,2015,0,queencrab20150929,queen crab2015
4,2014-07-25,happy christmas,70000,30312,30312,2014,0,happychristmas20140725,happy christmas2014
5,2005-01-28,"peace, propaganda and the promised land",70000,4930,4930,2005,0,peacepropagandaandthepromisedland20050128,"peace, propaganda and the promised land2005"
6,2011-12-31,absentia,70000,0,8555,2011,8555,absentia20111231,absentia2011
10,2004-05-07,super size me,65000,11529368,22233808,2004,10704440,supersizeme20040507,super size me2004
11,2013-01-25,supporting characters,60000,4917,4917,2013,0,supportingcharacters20130125,supporting characters2013
12,2012-03-16,the fp,60000,0,0,2012,0,thefp20120316,the fp2012
13,2012-12-31,hayride,60000,0,0,2012,0,hayride20121231,hayride2012
15,2013-10-04,the dirties,55000,0,0,2013,0,thedirties20131004,the dirties2013
17,2001-03-16,gabriela,50000,2335352,2335352,2001,0,gabriela20010316,gabriela2001
18,2010-11-12,tiny furniture,50000,391674,424149,2010,32475,tinyfurniture20101112,tiny furniture2010
19,2008-02-22,the signal,50000,251150,406299,2008,155149,thesignal20080222,the signal2008
20,2015-07-31,counting,50000,8374,8374,2015,0,counting20150731,counting2015
21,2009-12-31,big things,50000,0,0,2009,0,bigthings20091231,big things2009
22,2014-02-14,down and dangerous,50000,0,0,2014,0,downanddangerous20140214,down and dangerous2014
23,2005-12-31,the call of cthulhu,50000,0,0,2005,0,thecallofcthulhu20051231,the call of cthulhu2005
24,2015-08-04,bending steel,50000,0,0,2015,0,bendingsteel20150804,bending steel2015
25,2015-09-01,"run, hide, die",50000,0,0,2015,0,runhidedie20150901,"run, hide, die2015"
26,2014-12-31,the image revolution,50000,0,0,2014,0,theimagerevolution20141231,the image revolution2014
27,2013-10-25,a true story,45000,0,0,2013,0,atruestory20131025,a true story2013
28,2000-10-27,george washington,42000,241816,342722,2000,100906,georgewashington20001027,george washington2000
29,2013-06-21,this is martin bonner,42000,0,0,2013,0,thisismartinbonner20130621,this is martin bonner2013
30,2000-08-25,smiling fish and goat on fire,40000,277233,277233,2000,0,smilingfishandgoatonfire20000825,smiling fish and goat on fire2000
31,2010-03-12,the exploding girl,40000,25572,25572,2010,0,theexplodinggirl20100312,the exploding girl2010
32,2011-02-11,raymond did it,40000,3632,3632,2011,0,raymonddidit20110211,raymond did it2011
33,2012-03-31,foreign letters,40000,0,0,2012,0,foreignletters20120331,foreign letters2012
35,2013-10-25,her cry: la llorona investigation,35000,0,0,2013,0,hercrylalloronainvestigation20131025,her cry: la llorona investigation2013
36,2014-12-31,happy 40th,35000,0,0,2014,0,happy40th20141231,happy 40th2014
37,2008-07-18,the legend of god's gun,30000,243768,243768,2008,0,thelegendofgodsgun20080718,the legend of god's gun2008
38,2016-03-18,krisha,30000,144822,144822,2016,0,krisha20160318,krisha2016
39,2006-09-01,mutual appreciation,30000,103509,103509,2006,0,mutualappreciation20060901,mutual appreciation2006
40,2005-04-29,funny ha ha,30000,77070,82698,2005,5628,funnyhaha20050429,funny ha ha2005
41,2010-10-15,down terrace,30000,9812,9812,2010,0,downterrace20101015,down terrace2010
42,2013-12-31,paraphobia,30000,0,0,2013,0,paraphobia20131231,paraphobia2013
45,2017-01-27,emily,27000,3547,3547,2017,0,emily20170127,emily2017
48,2000-01-14,the terrorist,25000,195043,195043,2000,0,theterrorist20000114,the terrorist2000
49,2015-09-01,exeter,25000,0,489792,2015,489792,exeter20150901,exeter2015
50,2003-06-13,manito,25000,0,0,2003,0,manito20030613,manito2003
51,2015-04-21,ten,25000,0,0,2015,0,ten20150421,ten2015
52,2015-12-01,dutch kills,25000,0,0,2015,0,dutchkills20151201,dutch kills2015
54,2014-12-31,dry spell,22000,0,0,2014,0,dryspell20141231,dry spell2014
55,2003-12-31,flywheel,20000,0,0,2003,0,flywheel20031231,flywheel2003
56,2013-01-04,all superheroes must die,20000,0,0,2013,0,allsuperheroesmustdie20130104,all superheroes must die2013
57,2015-04-21,the front man,20000,0,0,2015,0,thefrontman20150421,the front man2015
58,2003-12-01,steel spirit,20000,0,0,2003,0,steelspirit20031201,steel spirit2003
59,2011-11-25,the ridges,17300,0,0,2011,0,theridges20111125,the ridges2011
60,2006-06-02,the puffy chair,15000,194523,195254,2006,731,thepuffychair20060602,the puffy chair2006
61,2010-04-02,breaking upwards,15000,115592,115592,2010,0,breakingupwards20100402,breaking upwards2010
62,2014-12-31,stories of our lives,15000,0,0,2014,0,storiesofourlives20141231,stories of our lives2014
64,2006-04-28,grip: a criminal's story,12000,1336,1336,2006,0,gripacriminalsstory20060428,grip: a criminal's story2006
65,2007-12-31,tin can man,12000,0,0,2007,0,tincanman20071231,tin can man2007
66,2001-03-09,dayereh,10000,673780,673780,2001,0,dayereh20010309,dayereh2001
67,2006-04-28,clean,10000,138711,138711,2006,0,clean20060428,clean2006
68,2001-07-06,cure,10000,94596,94596,2001,0,cure20010706,cure2001
69,2004-05-28,on the downlow,10000,1987,1987,2004,0,onthedownlow20040528,on the downlow2004
71,2008-08-14,the rise and fall of miss thang,10000,401,401,2008,0,theriseandfallofmissthang20080814,the rise and fall of miss thang2008
72,2015-05-19,family motocross,10000,0,0,2015,0,familymotocross20150519,family motocross2015
73,2012-01-13,newlyweds,9000,4584,4584,2012,0,newlyweds20120113,newlyweds2012
75,2004-10-08,primer,7000,424760,841926,2004,417166,primer20041008,primer2004
76,2006-05-26,cavite,7000,70071,71644,2006,1573,cavite20060526,cavite2006
77,2004-12-31,the mongol king,7000,900,900,2004,0,themongolking20041231,the mongol king2004
78,2018-12-31,red 11,7000,0,0,2018,0,red1120181231,red 112018
80,2005-07-13,return to the land of wonders,5000,1338,1338,2005,0,returntothelandofwonders20050713,return to the land of wonders2005
81,2015-09-29,a plague so pleasant,1400,0,0,2015,0,aplaguesopleasant20150929,a plague so pleasant2015
82,2005-08-05,my date with drew,1100,181041,181041,2005,0,mydatewithdrew20050805,my date with drew2005
